"POSITION","REF_CODON","CODON","REF_AA","AA","FWD_CNT","FWD_DENOM","REV_CNT","REV_DENOM","CNT","DENOM","std.bias","id"
161,"TTT","TTG","F","L",0,303367,8,333798,8,637165,4.218181843242,1703
175,"TAT","TCT","Y","S",593,300779,2,321540,595,622319,10.5765562964628,1850
214,"GAA","GAC","E","D",0,300514,7,315197,7,615711,4.08058611622823,2241
235,"AAG","AAA","K","K",0,292719,7,306716,7,599435,4.08246077125948,2446
293,"ATG","ACG","M","T",8,342501,0,278785,8,621286,4.00122598843679,3032
351,"TTC","GTC","F","V",0,319125,9,323348,9,642473,4.58903706054427,3617
368,"ATA","ACA","I","T",9,329311,340,276485,349,605796,7.05919357609817,3789
368,"ATA","AGA","I","R",2,329311,1313,276485,1315,605796,12.1644414513414,3790
390,"GTT","GTG","V","V",8,360508,0,306918,8,667426,4.08953148740726,4024
391,"GGA","AGT","G","S",25,366049,771,303989,796,670038,6.78255409285047,4028
432,"CTA","CGA","L","R",0,316772,8,370386,8,687158,4.09849158202903,4445
594,"AAC","AGC","N","S",9,272366,0,252762,9,525128,4.46725484281514,6087
595,"TCA","TTA","S","L",17,277251,454,242956,471,520207,6.46104830658905,6101
596,"GAA","GAG","E","E",11,278340,0,240913,11,519253,4.69024757963836,6107
612,"GTA","GAA","V","E",0,260032,8,259178,8,519210,4.40663934092409,6270
752,"TTT","TTA","F","L",16,190162,309,283197,325,473359,5.0188566478715,7677
753,"TTG","GTG","L","V",13,191524,285,282217,298,473741,5.26574476001757,7683
841,"ACT","ACG","T","T",164,76511,4,1026769,168,1103280,6.99302019976684,8620
842,"AGG","CGT","R","R",164,62075,0,1042892,164,1104967,10.2118910772113,8640
