"POSITION","REF_CODON","CODON","REF_AA","AA","FWD_CNT","FWD_DENOM","REV_CNT","REV_DENOM","CNT","DENOM","std.bias","id"
113,"GAT","GTT","D","V",3,387779,151,369809,154,757588,7.27580146494088,1419
114,"AGT","AAT","S","N",16,391841,1,374386,17,766227,4.20418582209594,1421
346,"CTG","CGG","L","R",0,390363,13,395560,13,785923,5.25689536031877,3460
368,"ATA","AGA","I","R",0,430344,47,406032,47,836376,7.74278822064242,3659
436,"TTG","TCG","L","S",0,406349,7,439763,7,846112,4.01900801532468,4244
444,"GGC","GCC","G","A",7,404281,0,446482,7,850763,4.17161132255254,4309
462,"TTC","TTT","F","F",0,402145,7,409187,7,811332,4.14031401673062,4461
518,"GCA","GCT","A","A",0,341987,11,397197,11,739184,4.67997262447538,4935
560,"ACT","CCT","T","P",7,341664,0,346334,7,687998,4.17397440576016,5289
570,"CAG","CCG","Q","P",8,367312,0,325836,8,693148,4.17045627461308,5371
760,"TCA","TCG","S","S",7,302420,0,377236,7,679656,4.16887466771636,7013
827,"AAG","AGG","K","R",25,837287,0,603325,25,1440612,5.86370678549135,7745
