"POSITION","REF_CODON","CODON","REF_AA","AA","FWD_CNT","FWD_DENOM","REV_CNT","REV_DENOM","CNT","DENOM","std.bias","id"
113,"GAT","GTT","D","V",69,176694,3243,154309,3312,331003,7.67247482657136,1524
278,"AGT","ATT","S","I",12,139039,0,139519,12,278558,5.13575624972702,3718
368,"ATA","AGA","I","R",0,162417,31,125258,31,287675,6.93205220643534,4779
391,"GGA","AGT","G","S",2,166337,23,146560,25,312897,4.17097619142605,5083
500,"ATA","CTA","I","L",104,139255,4,146238,108,285493,6.09109599777192,6546
579,"GCC","GGA","A","G",8,149823,0,130039,8,279862,4.12697827712633,7746
590,"ACA","GAG","T","E",8,155360,0,134190,8,289550,4.11809396675069,7966
652,"TCA","GAC","S","D",16,136386,1,146706,17,283092,4.29201552979589,8726
668,"GCA","TCG","A","S",0,140724,7,142191,7,282915,4.15375562327134,8992
752,"TTT","TTA","F","L",0,112150,15,143847,15,255997,5.05400657851726,10076
