coverage,wt.counts,mut.count,s.count,ns.count,stp.count,aa.sampled,codons.sampled
338505,338238,267,0,267,0,14,14
338297,338280,17,17,0,0,0,1
336459,336244,215,0,215,0,10,10
334119,333339,780,38,742,0,17,18
341940,341882,58,0,58,0,3,3
337094,336580,514,0,514,0,13,13
335240,334525,715,0,715,0,13,13
333411,332948,463,0,463,0,18,18
329910,329718,192,139,53,0,2,3
336871,336681,190,0,190,0,8,8
337727,337684,43,0,43,0,3,3
252793,252701,92,45,47,0,2,3
252233,252233,0,0,0,0,0,0
257613,257611,2,0,2,0,1,1
263301,263281,20,0,20,0,2,2
270814,270060,754,0,754,0,19,19
274721,274248,473,0,473,0,19,19
280965,280224,741,0,741,0,19,19
282145,282049,96,0,96,0,2,2
289690,289371,319,78,241,0,10,11
289523,288666,857,0,857,0,19,19
289974,289698,276,0,276,0,11,11
285808,285109,699,0,699,0,17,17
288180,288151,29,0,29,0,2,2
290670,290328,342,61,281,0,11,12
291199,290945,254,0,254,0,7,7
294103,293091,1012,0,1012,0,18,18
293729,293163,566,0,566,0,16,16
297089,296108,981,0,981,0,19,19
299321,298461,860,0,860,0,17,17
300354,299680,674,0,674,0,13,13
306099,305652,447,0,447,0,9,9
307409,307385,24,0,24,0,2,2
308304,307765,539,0,539,0,16,16
311716,311343,373,0,373,0,11,11
309269,309098,171,0,171,0,3,3
309066,308210,856,0,856,0,18,18
314477,314465,12,0,12,0,1,1
314289,314002,287,98,189,0,4,5
312198,311839,359,55,304,0,8,9
309590,308508,1082,0,1082,0,18,18
310046,309867,179,51,128,0,5,6
305438,305222,216,0,216,0,5,5
299814,299471,343,0,343,0,12,12
295017,294601,416,61,355,0,13,14
289533,288906,627,0,627,0,18,18
277427,276563,864,0,864,0,19,19
274976,274602,374,0,374,0,5,5
273341,272690,651,51,600,0,12,13
276232,275272,960,0,960,0,18,18
274868,274779,89,0,89,0,2,2
275280,275086,194,0,194,0,5,5
274512,273696,816,0,816,0,17,17
269714,268937,777,0,777,0,17,17
262871,262596,275,0,275,0,8,8
262180,261818,362,0,362,0,11,11
264042,263965,77,0,77,0,3,3
265406,265123,283,33,250,0,8,9
267099,266442,657,0,657,0,16,16
268226,267846,380,0,380,0,15,15
268830,268439,391,0,391,0,15,15
273990,273186,804,0,804,0,19,19
273113,272313,800,0,800,0,19,19
275282,274417,865,58,807,0,12,13
279469,278313,1156,0,1156,0,19,19
279901,279183,718,100,618,0,16,17
285486,284157,1329,0,1329,0,18,18
287043,286558,485,0,485,0,9,9
289293,289177,116,0,116,0,5,5
289501,289189,312,0,311,1,7,7
289260,288896,364,0,364,0,12,12
287571,287348,223,0,223,0,3,3
288499,288112,387,105,282,0,9,10
288901,288783,118,103,15,0,1,2
288345,288085,260,0,260,0,8,8
287394,287385,9,0,9,0,2,2
289425,289423,2,0,2,0,2,2
293975,293720,255,0,255,0,7,7
293892,293615,277,129,148,0,3,4
294868,294811,57,0,57,0,4,4
296455,296455,0,0,0,0,0,0
295636,295160,476,41,435,0,8,9
297063,296958,105,0,105,0,1,1
297551,297551,0,0,0,0,0,0
292712,292712,0,0,0,0,0,0
291164,291017,147,0,147,0,7,7
290763,290322,441,80,361,0,7,8
289912,289657,255,0,255,0,5,5
286859,286740,119,0,119,0,4,4
287214,287100,114,0,114,0,5,5
288914,288588,326,0,326,0,9,9
291109,290954,155,0,155,0,5,5
291052,290872,180,0,180,0,6,6
295747,295418,329,0,329,0,7,7
294904,294595,309,0,309,0,6,6
287605,287497,108,0,108,0,6,6
287550,287275,275,0,275,0,9,9
286562,286368,194,96,98,0,5,6
283755,283559,196,0,196,0,3,3
285577,285577,0,0,0,0,0,0
292140,292086,54,0,54,0,4,4
294221,294153,68,0,68,0,3,3
291569,291564,5,0,5,0,1,1
294098,294092,6,0,6,0,1,1
294155,294116,39,0,39,0,2,2
291784,291784,0,0,0,0,0,0
296757,296573,184,0,184,0,6,6
299703,299698,5,0,5,0,1,1
299131,298408,723,0,723,0,14,14
299044,298829,215,0,215,0,12,12
301939,300794,1145,0,1145,0,19,19
303989,302513,1476,0,1476,0,19,19
302004,301641,363,0,363,0,14,14
303168,302285,883,0,883,0,16,16
311492,311136,356,54,302,0,14,15
311324,311191,133,0,133,0,4,4
312475,312475,0,0,0,0,0,0
313545,313516,29,0,29,0,2,2
319210,319018,192,100,92,0,3,4
322105,321966,139,122,17,0,2,3
322810,322637,173,0,173,0,13,13
326202,326201,1,0,1,0,1,1
327358,326942,416,0,416,0,12,12
325686,325672,14,0,14,0,1,1
329328,329319,9,0,9,0,1,1
327232,327232,0,0,0,0,0,0
331145,331123,22,0,22,0,2,2
326325,325948,377,0,377,0,12,12
330908,330908,0,0,0,0,0,0
329372,329185,187,0,187,0,8,8
334014,334014,0,0,0,0,0,0
336912,336898,14,0,14,0,2,2
335298,335027,271,0,271,0,10,10
338792,338607,185,0,185,0,2,2
336277,336132,145,0,145,0,4,4
337307,337269,38,0,38,0,2,2
338132,338047,85,0,85,0,2,2
341718,341587,131,105,26,0,2,3
344883,344875,8,0,8,0,2,2
339454,339196,258,40,218,0,5,6
343372,342473,899,141,758,0,16,17
346005,345746,259,0,259,0,10,10
347431,346967,464,0,464,0,6,6
348301,347891,410,0,410,0,16,16
350687,350687,0,0,0,0,0,0
350808,350391,417,0,417,0,17,17
345981,345752,229,0,229,0,13,13
349525,349525,0,0,0,0,0,0
352378,352377,1,0,1,0,1,1
350317,350212,105,0,105,0,1,1
349005,349004,1,0,1,0,1,1
349300,349261,39,0,39,0,1,1
349452,349261,191,150,41,0,2,3
347470,347470,0,0,0,0,0,0
351192,351087,105,0,105,0,4,4
348197,348143,54,0,54,0,4,4
350331,350125,206,0,206,0,8,8
345739,345538,201,93,108,0,6,7
343008,342935,73,0,73,0,6,6
343777,343660,117,0,117,0,4,4
345586,345551,35,0,35,0,3,3
346053,345771,282,186,96,0,4,5
345350,345350,0,0,0,0,0,0
345738,345570,168,92,76,0,3,4
342765,342755,10,0,10,0,1,1
339947,339849,98,0,98,0,1,1
340662,340054,608,0,608,0,16,16
339633,339631,2,0,2,0,1,1
343000,342964,36,0,36,0,3,3
338512,337293,1219,0,1219,0,19,19
343083,341969,1114,0,1114,0,18,18
342061,341904,157,0,157,0,3,3
344667,343783,884,131,753,0,15,16
345583,345035,548,0,548,0,7,7
343150,342812,338,0,338,0,14,14
343578,342382,1196,0,1196,0,17,17
341442,339773,1669,0,1669,0,18,18
339510,337857,1653,0,1653,0,19,19
336768,336532,236,0,236,0,8,8
337202,336073,1129,0,1129,0,19,19
341502,341325,177,0,177,0,5,5
342771,341274,1497,132,1365,0,18,19
338109,337887,222,0,222,0,15,15
332485,332350,135,0,135,0,8,8
330308,329860,448,0,448,0,16,16
334996,334805,191,0,191,0,11,11
332936,332743,193,146,47,0,2,3
328601,328189,412,0,412,0,12,12
334754,334646,108,0,108,0,10,10
333370,332064,1306,0,1306,0,19,19
335647,335240,407,0,407,0,13,13
330429,330079,350,0,350,0,12,12
333976,333283,693,0,693,0,14,14
335554,335553,1,0,1,0,1,1
334771,334655,116,114,2,0,1,2
334246,334245,1,0,1,0,1,1
337088,336908,180,23,157,0,3,4
341800,341643,157,0,157,0,6,6
341361,340859,502,186,316,0,6,7
344892,344549,343,67,276,0,5,6
343652,343198,454,0,454,0,11,11
343408,343161,247,103,144,0,6,7
342804,341880,924,0,924,0,18,18
341828,341696,132,76,56,0,2,3
339976,339787,189,0,189,0,11,11
341153,340515,638,0,638,0,16,16
342600,342536,64,0,64,0,3,3
343154,343086,68,0,68,0,2,2
341391,341292,99,99,0,0,0,1
342088,342084,4,0,4,0,1,1
340924,340879,45,0,45,0,2,2
333156,332967,189,189,0,0,0,1
335131,334944,187,0,187,0,7,7
334914,334833,81,0,81,0,5,5
331912,331619,293,100,193,0,5,6
331258,330754,504,0,504,0,16,16
329654,328619,1035,0,1035,0,16,16
328070,327761,309,0,309,0,10,10
323999,322677,1322,0,1322,0,19,19
324914,324175,739,0,739,0,17,17
328945,328187,758,0,757,1,20,20
328293,327697,596,0,596,0,14,14
327098,326313,785,0,785,0,13,13
324824,324388,436,0,436,0,12,12
325236,325186,50,0,50,0,1,1
321281,321097,184,0,184,0,8,8
324795,324697,98,97,1,0,1,2
326871,326830,41,0,41,0,2,2
326719,326708,11,0,11,0,2,2
326455,326448,7,0,7,0,2,2
327444,327430,14,0,14,0,1,1
326228,326040,188,18,170,0,9,10
328098,328007,91,0,91,0,9,9
332766,332753,13,0,13,0,2,2
334575,334565,10,0,10,0,4,4
336790,336670,120,0,120,0,8,8
338832,338826,6,0,6,0,1,1
335990,335939,51,0,51,0,2,2
335056,335039,17,0,17,0,2,2
338743,338743,0,0,0,0,0,0
337927,337927,0,0,0,0,0,0
337780,337780,0,0,0,0,0,0
339686,339308,378,0,378,0,15,15
338313,338305,8,0,8,0,1,1
340470,339776,694,0,694,0,16,16
339921,339585,336,0,336,0,14,14
338028,338009,19,0,19,0,2,2
340267,340267,0,0,0,0,0,0
338434,338428,6,0,6,0,1,1
337346,337269,77,29,48,0,2,3
336784,336619,165,0,165,0,11,11
340525,340487,38,38,0,0,0,1
343468,343233,235,0,235,0,4,4
345980,345980,0,0,0,0,0,0
351220,350749,471,0,471,0,16,16
352664,352659,5,0,5,0,2,2
350347,350324,23,0,23,0,2,2
347117,346868,249,0,249,0,10,10
350135,350083,52,44,8,0,1,2
351115,351033,82,0,82,0,4,4
353627,353562,65,51,14,0,3,4
360849,360832,17,0,17,0,1,1
358792,358792,0,0,0,0,0,0
360769,360767,2,0,2,0,1,1
354884,354884,0,0,0,0,0,0
357519,357518,1,0,1,0,1,1
354759,354759,0,0,0,0,0,0
357140,357096,44,23,21,0,1,2
360984,360951,33,0,33,0,3,3
361850,361850,0,0,0,0,0,0
364455,364436,19,0,19,0,2,2
369828,369828,0,0,0,0,0,0
370687,370687,0,0,0,0,0,0
373532,373532,0,0,0,0,0,0
374964,374864,100,0,100,0,2,2
371148,371045,103,103,0,0,0,1
371636,371616,20,0,20,0,3,3
370151,369862,289,77,212,0,4,5
365839,365705,134,0,134,0,5,5
364972,364972,0,0,0,0,0,0
363637,363587,50,0,50,0,3,3
365938,365930,8,0,8,0,1,1
365987,365797,190,128,62,0,2,3
363322,363320,2,0,2,0,1,1
366722,366603,119,0,119,0,2,2
362558,362558,0,0,0,0,0,0
364543,364541,2,0,2,0,1,1
361147,361147,0,0,0,0,0,0
360346,360346,0,0,0,0,0,0
334682,334681,1,0,1,0,1,1
352688,352688,0,0,0,0,0,0
349644,349637,7,0,7,0,1,1
346150,346149,1,0,1,0,1,1
344773,344773,0,0,0,0,0,0
346580,346580,0,0,0,0,0,0
350510,350388,122,103,19,0,1,2
350211,350211,0,0,0,0,0,0
350950,350839,111,0,111,0,9,9
351449,351395,54,46,8,0,2,3
354593,354291,302,33,269,0,7,8
352390,352043,347,0,347,0,12,12
352204,351884,320,0,320,0,13,13
352879,352879,0,0,0,0,0,0
348481,348481,0,0,0,0,0,0
348513,348222,291,0,291,0,9,9
345855,345723,132,0,132,0,6,6
344090,343421,669,0,669,0,19,19
340028,340026,2,0,2,0,1,1
342245,342245,0,0,0,0,0,0
338778,338026,752,0,752,0,18,18
335974,335892,82,0,82,0,3,3
337915,337224,691,0,691,0,18,18
334014,333563,451,0,451,0,14,14
332296,331925,371,0,371,0,11,11
331503,331077,426,0,426,0,14,14
328871,328172,699,75,624,0,19,20
324670,324515,155,35,120,0,5,6
323934,322965,969,0,969,0,18,18
326591,325507,1084,0,1084,0,19,19
323130,322640,490,0,490,0,15,15
329348,329305,43,0,43,0,5,5
337045,336944,101,0,101,0,4,4
338374,338248,126,0,126,0,11,11
338865,338364,501,0,501,0,16,16
342107,342028,79,0,79,0,3,3
339766,339466,300,0,300,0,9,9
342543,341900,643,0,643,0,14,14
343838,343725,113,0,113,0,9,9
344736,343693,1043,143,900,0,19,20
344676,344237,439,0,439,0,16,16
344876,344773,103,0,103,0,1,1
341497,341412,85,0,85,0,4,4
341223,340989,234,52,182,0,5,6
342410,342153,257,0,257,0,12,12
340824,340793,31,0,31,0,4,4
344354,344296,58,58,0,0,0,1
344928,344879,49,0,49,0,5,5
343934,343867,67,0,67,0,1,1
338342,338016,326,0,326,0,8,8
336886,336141,745,0,745,0,19,19
332775,332666,109,0,109,0,5,5
329754,329754,0,0,0,0,0,0
335474,334797,677,0,677,0,18,18
339903,339882,21,0,21,0,1,1
333961,332867,1094,0,1094,0,18,18
334681,334529,152,0,152,0,9,9
339751,339621,130,0,130,0,7,7
337985,337985,0,0,0,0,0,0
336624,336542,82,0,82,0,2,2
340293,340235,58,0,58,0,4,4
340578,340350,228,107,121,0,4,5
340652,339893,759,25,734,0,17,18
339019,338401,618,52,566,0,18,19
340372,339769,603,0,603,0,15,15
337584,337584,0,0,0,0,0,0
340031,339774,257,0,257,0,16,16
334951,334806,145,145,0,0,0,1
333070,332855,215,43,172,0,6,7
325521,325122,399,0,399,0,16,16
325055,324662,393,0,393,0,17,17
317666,317319,347,0,347,0,15,15
315171,315171,0,0,0,0,0,0
319323,319083,240,0,240,0,13,13
317310,317051,259,0,259,0,14,14
317380,317256,124,0,124,0,6,6
314756,314710,46,0,46,0,3,3
317983,317968,15,0,15,0,1,1
319891,319612,279,26,253,0,10,11
319302,319296,6,0,6,0,2,2
319238,319238,0,0,0,0,0,0
315745,315301,444,0,444,0,14,14
318322,318322,0,0,0,0,0,0
323322,323322,0,0,0,0,0,0
324004,323662,342,0,342,0,8,8
327663,327023,640,0,640,0,19,19
330129,329450,679,0,679,0,18,18
331027,329952,1075,0,1075,0,19,19
332876,332716,160,0,160,0,9,9
339985,339984,1,0,1,0,1,1
343573,343188,385,0,385,0,14,14
343244,343193,51,0,51,0,4,4
343521,343502,19,0,19,0,2,2
340203,339466,737,130,607,0,17,18
341531,341363,168,0,168,0,7,7
342437,342400,37,0,37,0,1,1
341180,341060,120,0,120,0,5,5
344908,344857,51,0,51,0,6,6
346920,346815,105,0,105,0,6,6
343678,343678,0,0,0,0,0,0
340156,339961,195,0,195,0,10,10
338874,338282,592,0,592,0,14,14
342206,341837,369,0,369,0,13,13
337308,337246,62,57,5,0,1,2
338715,338017,698,0,698,0,13,13
339356,338991,365,0,365,0,12,12
343229,343100,129,97,32,0,3,4
345956,345501,455,0,455,0,13,13
349219,349197,22,0,22,0,4,4
350930,350408,522,67,455,0,16,17
352685,352366,319,0,319,0,11,11
354899,354257,642,0,642,0,17,17
353328,353140,188,0,188,0,8,8
352105,351906,199,0,199,0,3,3
349731,349170,561,0,561,0,16,16
354797,354731,66,39,27,0,2,3
353650,353395,255,0,255,0,15,15
352411,352234,177,0,177,0,12,12
352049,352017,32,0,32,0,2,2
356266,356211,55,0,55,0,3,3
350364,350364,0,0,0,0,0,0
353000,353000,0,0,0,0,0,0
346218,346129,89,0,89,0,6,6
342816,341924,892,0,892,0,19,19
341214,341214,0,0,0,0,0,0
333479,333344,135,112,23,0,1,2
336842,336655,187,0,187,0,7,7
340032,339821,211,0,211,0,7,7
338272,338072,200,151,49,0,3,4
337296,337251,45,0,45,0,3,3
338530,338368,162,84,78,0,3,4
336898,336394,504,0,504,0,13,13
334401,334337,64,0,64,0,2,2
337003,336899,104,104,0,0,0,1
337217,337217,0,0,0,0,0,0
339593,339593,0,0,0,0,0,0
340363,340311,52,0,52,0,3,3
341519,341519,0,0,0,0,0,0
340025,340017,8,0,8,0,1,1
336788,336615,173,0,173,0,6,6
338887,338581,306,0,306,0,12,12
342106,341806,300,30,270,0,13,14
340681,340674,7,0,7,0,3,3
334928,334724,204,0,204,0,4,4
333342,333203,139,0,139,0,8,8
337339,337338,1,0,1,0,1,1
330675,330565,110,40,70,0,6,7
326312,326280,32,0,32,0,2,2
333800,333737,63,0,63,0,3,3
336312,336067,245,124,121,0,4,5
335322,335060,262,60,202,0,15,16
331744,331313,431,0,431,0,17,17
334440,334160,280,0,280,0,8,8
332452,332238,214,0,214,0,15,15
332109,331967,142,0,142,0,6,6
340953,340813,140,0,140,0,8,8
343217,342788,429,164,265,0,5,6
341736,341225,511,0,511,0,16,16
344044,343644,400,0,400,0,15,15
341098,340941,157,88,69,0,3,4
343630,343410,220,0,220,0,11,11
345610,345040,570,0,570,0,17,17
351994,351880,114,0,114,0,5,5
350508,350337,171,0,171,0,2,2
355574,355455,119,0,119,0,8,8
350830,350749,81,0,81,0,8,8
350539,350482,57,0,57,0,2,2
350245,350245,0,0,0,0,0,0
350181,350077,104,56,48,0,4,5
350971,350670,301,0,301,0,14,14
347115,346966,149,39,110,0,4,5
346994,346994,0,0,0,0,0,0
346855,346749,106,0,106,0,6,6
349035,348937,98,0,98,0,4,4
352123,352123,0,0,0,0,0,0
350822,350774,48,0,48,0,1,1
349499,349467,32,0,32,0,1,1
345565,345565,0,0,0,0,0,0
345386,345385,1,0,1,0,1,1
341698,341698,0,0,0,0,0,0
341423,341391,32,24,8,0,1,2
344486,343848,638,77,561,0,12,13
341809,341232,577,22,555,0,12,13
337371,336057,1314,0,1314,0,19,19
338107,337857,250,0,250,0,10,10
342487,342170,317,0,317,0,8,8
340513,340350,163,0,163,0,1,1
340570,339513,1057,0,1057,0,18,18
340360,339539,821,0,821,0,18,18
341023,341023,0,0,0,0,0,0
336562,336074,488,0,488,0,14,14
335110,335081,29,28,1,0,1,2
337882,337836,46,23,23,0,2,3
338986,338812,174,7,167,0,5,6
338311,338273,38,0,38,0,2,2
336777,336775,2,0,2,0,1,1
337693,337628,65,0,65,0,2,2
338628,338356,272,83,189,0,6,7
338787,338714,73,72,1,0,1,2
339235,339080,155,87,68,0,5,6
334509,334508,1,0,1,0,1,1
332920,332918,2,0,2,0,1,1
328442,328429,13,13,0,0,0,1
325942,325907,35,0,35,0,2,2
320334,320224,110,0,110,0,3,3
321361,321269,92,0,92,0,3,3
314750,314693,57,57,0,0,0,1
312110,312079,31,0,31,0,4,4
311136,311062,74,0,74,0,6,6
307398,307356,42,0,42,0,1,1
309120,309120,0,0,0,0,0,0
315821,315539,282,0,282,0,12,12
315887,315790,97,41,56,0,1,2
313764,313725,39,0,39,0,2,2
312194,311847,347,0,347,0,10,10
312397,311862,535,0,535,0,14,14
313994,313964,30,0,30,0,1,1
314204,314196,8,0,8,0,1,1
316480,315848,632,50,582,0,16,17
312857,312689,168,0,168,0,11,11
312723,312707,16,0,16,0,4,4
318176,318168,8,0,8,0,1,1
323827,323638,189,0,189,0,7,7
330871,330572,299,0,299,0,12,12
335167,335144,23,0,23,0,1,1
336357,336357,0,0,0,0,0,0
331196,331085,111,49,62,0,2,3
328304,328304,0,0,0,0,0,0
327311,327303,8,0,8,0,1,1
324940,324921,19,0,19,0,1,1
326311,326293,18,0,18,0,2,2
323373,323270,103,0,103,0,3,3
318743,318743,0,0,0,0,0,0
317056,317054,2,0,2,0,1,1
313705,313292,413,79,334,0,12,13
313946,313946,0,0,0,0,0,0
316805,316761,44,0,44,0,2,2
317591,317451,140,140,0,0,0,1
317893,317824,69,0,69,0,6,6
315377,315346,31,0,31,0,1,1
313136,313080,56,0,56,0,2,2
311927,311763,164,0,164,0,9,9
316714,316597,117,0,117,0,5,5
317698,317645,53,41,12,0,3,4
316416,316007,409,0,409,0,16,16
314934,314870,64,0,64,0,6,6
317221,316915,306,0,306,0,13,13
314952,314901,51,51,0,0,0,1
314831,314772,59,0,59,0,3,3
314310,314185,125,0,125,0,8,8
312317,312269,48,0,48,0,6,6
311504,311504,0,0,0,0,0,0
310367,310367,0,0,0,0,0,0
311348,311168,180,22,158,0,8,9
306743,306525,218,0,218,0,13,13
306218,306206,12,0,12,0,1,1
304267,304267,0,0,0,0,0,0
303082,303041,41,0,41,0,2,2
301095,300914,181,145,36,0,4,5
298868,298677,191,178,13,0,2,3
295716,295609,107,92,15,0,2,3
285958,285958,0,0,0,0,0,0
285255,285055,200,0,200,0,8,8
285213,285188,25,0,25,0,2,2
285521,285521,0,0,0,0,0,0
291377,289549,1828,0,1828,0,19,19
292143,291846,297,0,297,0,8,8
293485,293188,297,295,2,0,1,2
291190,291147,43,0,43,0,5,5
290957,289904,1053,0,1053,0,18,18
290746,290304,442,112,330,0,7,8
287171,286930,241,180,61,0,3,4
288434,286876,1558,0,1558,0,18,18
288023,287823,200,0,200,0,11,11
288544,288110,434,131,303,0,4,5
287672,287651,21,0,21,0,4,4
292627,292596,31,0,31,0,1,1
293627,292757,870,0,870,0,16,16
294082,292519,1563,0,1563,0,19,19
294797,293789,1008,0,1008,0,19,19
295925,295538,387,0,387,0,13,13
294075,293716,359,0,359,0,14,14
294808,293727,1081,0,1081,0,17,17
300421,300288,133,0,133,0,3,3
299230,298962,268,0,268,0,4,4
299411,299312,99,0,99,0,4,4
301935,301690,245,0,245,0,12,12
304223,304024,199,91,108,0,3,4
301991,301990,1,0,1,0,1,1
303766,303542,224,0,224,0,8,8
301578,301505,73,43,30,0,1,2
299054,298750,304,0,304,0,9,9
297919,297904,15,0,15,0,1,1
299216,298973,243,172,71,0,3,4
303420,303224,196,0,196,0,2,2
305182,304793,389,74,315,0,9,10
307999,307920,79,0,79,0,5,5
302133,301951,182,0,182,0,11,11
300055,299999,56,0,56,0,3,3
302151,302148,3,0,3,0,1,1
294761,293975,786,0,786,0,15,15
297638,297539,99,0,99,0,4,4
297255,296662,593,81,512,0,13,14
296675,296675,0,0,0,0,0,0
287920,287915,5,0,5,0,1,1
285808,285779,29,0,29,0,1,1
288711,288711,0,0,0,0,0,0
282055,281929,126,126,0,0,0,1
279844,279844,0,0,0,0,0,0
280726,280658,68,0,68,0,5,5
284680,284557,123,123,0,0,0,1
284243,284243,0,0,0,0,0,0
284612,284612,0,0,0,0,0,0
285770,285643,127,121,6,0,1,2
285008,284972,36,0,36,0,2,2
282582,282542,40,0,40,0,2,2
282894,282892,2,0,2,0,1,1
283350,283130,220,38,182,0,1,2
283633,283494,139,0,139,0,2,2
283690,283625,65,0,65,0,3,3
286985,286985,0,0,0,0,0,0
289430,289430,0,0,0,0,0,0
289176,288997,179,0,179,0,3,3
288519,288493,26,0,26,0,2,2
290509,290249,260,0,260,0,5,5
290818,290739,79,56,23,0,2,3
290314,290161,153,0,153,0,4,4
294110,293828,282,121,161,0,4,5
293846,293660,186,0,186,0,5,5
298017,297706,311,44,267,0,9,10
300301,300111,190,0,190,0,11,11
300617,300430,187,0,187,0,6,6
296521,296479,42,0,42,0,2,2
299397,299217,180,0,180,0,8,8
300310,299837,473,0,473,0,12,12
300531,300427,104,0,104,0,3,3
301581,301522,59,0,59,0,2,2
307396,307247,149,113,36,0,3,4
308803,308795,8,0,8,0,2,2
305537,304922,615,0,615,0,17,17
307218,307185,33,0,33,0,1,1
311197,311077,120,75,45,0,7,8
311360,311257,103,0,103,0,4,4
314336,314252,84,0,84,0,2,2
311373,311373,0,0,0,0,0,0
314179,314177,2,0,2,0,1,1
312541,312541,0,0,0,0,0,0
309739,309735,4,0,4,0,1,1
310865,310863,2,0,2,0,1,1
309635,309585,50,0,50,0,3,3
309827,309790,37,0,37,0,2,2
307420,307391,29,0,29,0,1,1
306518,306256,262,244,18,0,2,3
304899,304899,0,0,0,0,0,0
303438,303265,173,0,173,0,13,13
306955,306740,215,0,215,0,8,8
307605,307350,255,0,255,0,16,16
306600,306544,56,0,56,0,4,4
309815,309812,3,0,3,0,2,2
307336,307075,261,0,261,0,9,9
306123,305596,527,67,460,0,13,14
306183,305986,197,55,142,0,13,14
305135,305082,53,43,10,0,2,3
302278,302278,0,0,0,0,0,0
302926,302299,627,0,627,0,18,18
300804,300699,105,0,105,0,10,10
298909,298806,103,0,103,0,1,1
299517,299219,298,0,298,0,15,15
300653,300198,455,0,455,0,17,17
298053,298052,1,0,1,0,1,1
297698,297676,22,0,22,0,1,1
302530,302360,170,48,122,0,2,3
297694,297418,276,0,276,0,15,15
296569,296433,136,0,136,0,3,3
296608,296608,0,0,0,0,0,0
296025,296025,0,0,0,0,0,0
290535,290273,262,0,262,0,9,9
288170,288152,18,0,18,0,5,5
288298,288293,5,0,5,0,2,2
283207,282973,234,0,234,0,8,8
283901,283430,471,0,471,0,17,17
283839,283338,501,0,501,0,18,18
285577,285526,51,0,51,0,2,2
285039,284991,48,0,48,0,9,9
281704,281610,94,0,94,0,10,10
279227,279153,74,0,74,0,5,5
278231,278163,68,0,68,0,3,3
279252,279203,49,0,49,0,1,1
280092,279466,626,0,626,0,18,18
275753,275695,58,0,58,0,2,2
272805,272582,223,0,223,0,5,5
276753,276706,47,0,47,0,4,4
273733,273733,0,0,0,0,0,0
275103,275048,55,55,0,0,0,1
271811,271760,51,0,51,0,3,3
272674,272587,87,70,17,0,2,3
270314,270265,49,0,49,0,2,2
271298,271298,0,0,0,0,0,0
274452,274321,131,131,0,0,0,1
271850,271759,91,0,91,0,3,3
272452,272452,0,0,0,0,0,0
267906,267864,42,0,42,0,4,4
271427,271149,278,0,278,0,13,13
269495,269495,0,0,0,0,0,0
269385,269376,9,0,9,0,2,2
271812,271694,118,0,118,0,2,2
270586,270562,24,13,11,0,1,2
271125,271102,23,0,23,0,2,2
277477,277476,1,0,1,0,1,1
281113,281113,0,0,0,0,0,0
284289,284289,0,0,0,0,0,0
286346,286284,62,0,62,0,2,2
289719,289677,42,0,42,0,3,3
292690,292657,33,0,33,0,2,2
294288,294035,253,0,253,0,11,11
300425,300259,166,0,166,0,10,10
302975,302934,41,0,41,0,1,1
305239,304732,507,0,507,0,16,16
312556,312544,12,0,12,0,2,2
311332,311259,73,73,0,0,0,1
314292,314248,44,0,44,0,2,2
316083,315963,120,120,0,0,0,1
319824,319773,51,0,51,0,1,1
320552,320542,10,0,10,0,2,2
323211,323187,24,0,24,0,3,3
333049,332866,183,0,183,0,6,6
338609,338456,153,0,153,0,3,3
340351,340235,116,0,116,0,10,10
355850,355154,696,0,696,0,15,15
357718,357714,4,0,4,0,1,1
363953,363683,270,0,270,0,14,14
378817,378120,697,0,697,0,17,17
383361,383346,15,0,15,0,1,1
390076,389929,147,0,147,0,4,4
403124,402353,771,105,666,0,14,15
406037,405801,236,120,116,0,7,8
407297,407197,100,82,18,0,2,3
408091,408091,0,0,0,0,0,0
411396,409882,1514,109,1405,0,17,18
421787,421598,189,131,58,0,3,4
428507,428507,0,0,0,0,0,0
425503,425481,22,0,22,0,1,1
424824,424819,5,0,5,0,1,1
428080,427712,368,0,368,0,6,6
432056,432024,32,0,32,0,1,1
432399,431681,718,0,718,0,14,14
430109,428381,1728,0,1728,0,19,19
435523,435092,431,0,431,0,14,14
441852,441852,0,0,0,0,0,0
440089,439195,894,0,894,0,15,15
440884,440488,396,0,396,0,13,13
443370,443370,0,0,0,0,0,0
445746,445282,464,0,464,0,6,6
453319,452816,503,112,391,0,12,13
451053,450721,332,0,332,0,9,9
453034,453004,30,0,30,0,3,3
454161,453936,225,185,40,0,2,3
445580,445350,230,74,156,0,8,9
450530,450398,132,0,132,0,5,5
445576,445479,97,0,97,0,8,8
448776,448620,156,0,156,0,2,2
447265,447265,0,0,0,0,0,0
450474,450412,62,28,34,0,5,6
454268,454173,95,0,95,0,5,5
449668,449512,156,41,115,0,3,4
605420,603376,2044,0,2044,0,18,18
603309,602965,344,235,109,0,2,3
594630,594630,0,0,0,0,0,0
602319,601846,473,0,473,0,9,9
597199,596999,200,0,200,0,2,2
616536,616018,518,179,339,0,5,6
605887,604793,1094,0,1094,0,12,12
615079,614926,153,152,1,0,1,2
611302,611073,229,229,0,0,0,1
614776,614647,129,92,37,0,2,3
604438,603880,558,0,558,0,12,12
619017,618999,18,0,18,0,1,1
613940,613736,204,141,63,0,4,5
609577,609552,25,0,25,0,1,1
609170,608275,895,123,772,0,10,11
612879,612879,0,0,0,0,0,0
