coverage,wt.counts,mut.count,s.count,ns.count,stp.count,aa.sampled,codons.sampled
380928,380622,306,0,306,0,13,13
381527,381427,100,94,6,0,1,2
378552,378328,224,0,224,0,14,14
375786,374718,1068,23,1045,0,18,19
384213,384094,119,0,119,0,3,3
377701,377149,552,0,552,0,15,15
376078,375430,648,0,648,0,14,14
373791,373148,643,0,643,0,16,16
368934,368793,141,112,29,0,1,2
376365,376149,216,0,216,0,8,8
376534,376435,99,0,99,0,4,4
301733,301619,114,49,65,0,3,4
300325,300325,0,0,0,0,0,0
305544,305542,2,0,2,0,1,1
310299,310283,16,0,16,0,2,2
316851,316270,581,0,581,0,18,18
319595,319169,426,0,426,0,18,18
323977,323091,886,0,886,0,19,19
324629,324492,137,0,137,0,2,2
331314,330938,376,30,346,0,12,13
330122,329257,865,0,865,0,19,19
329075,328824,251,0,251,0,12,12
323075,322265,810,0,810,0,17,17
323482,323380,102,0,102,0,3,3
324682,324257,425,46,379,0,12,13
323904,323588,316,0,316,0,7,7
325771,324482,1289,0,1289,0,18,18
324195,323590,605,0,605,0,16,16
325849,324793,1056,0,1056,0,18,18
325965,325054,911,0,911,0,17,17
324624,324011,613,0,613,0,15,15
328527,328127,400,0,400,0,7,7
328419,328411,8,0,8,0,1,1
327150,326622,528,0,528,0,15,15
328808,328478,330,0,330,0,11,11
323287,323144,143,0,143,0,4,4
321871,320716,1155,0,1155,0,18,18
326776,326766,10,0,10,0,1,1
324920,324728,192,80,112,0,3,4
321010,320688,322,32,290,0,8,9
316182,315171,1011,0,1011,0,18,18
316153,315937,216,40,176,0,8,9
309614,309374,240,0,240,0,5,5
303379,303186,193,0,193,0,12,12
296085,295636,449,98,351,0,12,13
289206,288511,695,0,695,0,19,19
275194,274431,763,0,763,0,19,19
271649,271473,176,0,176,0,5,5
268190,267460,730,109,621,0,12,13
269806,268952,854,0,854,0,18,18
267748,267664,84,0,84,0,2,2
267675,267562,113,0,113,0,6,6
265789,265127,662,0,662,0,17,17
261156,260328,828,0,828,0,18,18
254039,253783,256,0,256,0,10,10
253854,253515,339,0,339,0,10,10
254818,254772,46,0,46,0,2,2
255234,254954,280,74,206,0,9,10
256314,255808,506,0,506,0,13,13
257322,256787,535,0,535,0,14,14
257482,256885,597,0,597,0,17,17
262329,261333,996,0,996,0,19,19
261406,260617,789,0,789,0,19,19
264250,263793,457,16,441,0,13,14
267710,266762,948,0,948,0,19,19
268329,267530,799,77,722,0,17,18
273116,272274,842,0,842,0,19,19
273938,273543,395,0,395,0,11,11
276999,276924,75,0,75,0,3,3
276846,276682,164,0,164,0,8,8
277347,277089,258,0,258,0,11,11
276530,276261,269,0,269,0,4,4
277998,277620,378,146,232,0,8,9
278672,278534,138,117,21,0,1,2
278621,278447,174,0,174,0,8,8
277910,277880,30,0,30,0,2,2
280295,280289,6,0,6,0,2,2
285192,284998,194,0,194,0,9,9
285248,285082,166,24,142,0,5,6
286680,286665,15,0,15,0,2,2
288431,288431,0,0,0,0,0,0
288121,287738,383,15,368,0,9,10
289427,289375,52,0,52,0,1,1
289835,289835,0,0,0,0,0,0
284355,284355,0,0,0,0,0,0
284281,284119,162,0,162,0,6,6
283622,283268,354,48,306,0,6,7
282958,282799,159,0,159,0,4,4
279626,279569,57,0,57,0,3,3
279827,279707,120,0,120,0,4,4
281684,281347,337,0,337,0,10,10
283838,283765,73,0,73,0,6,6
284397,284192,205,0,205,0,7,7
288421,288195,226,0,226,0,7,7
287685,287447,238,0,238,0,5,5
281790,281656,134,0,134,0,5,5
281426,281185,241,0,241,0,9,9
281150,281023,127,65,62,0,5,6
278393,278320,73,0,73,0,3,3
280520,280520,0,0,0,0,0,0
286687,286622,65,0,65,0,2,2
289001,288913,88,0,88,0,5,5
286581,286566,15,0,15,0,2,2
289654,289649,5,0,5,0,2,2
290362,290303,59,0,59,0,3,3
288783,288783,0,0,0,0,0,0
293679,293449,230,0,230,0,5,5
296237,296232,5,0,5,0,1,1
295493,294858,635,0,635,0,12,12
295485,295309,176,0,176,0,11,11
298447,297144,1303,0,1303,0,19,19
300459,299238,1221,0,1221,0,19,19
297915,297627,288,0,288,0,16,16
299750,299130,620,0,620,0,16,16
307308,306886,422,134,288,0,14,15
306474,306284,190,0,190,0,5,5
306759,306759,0,0,0,0,0,0
307754,307725,29,0,29,0,1,1
312776,312587,189,96,93,0,3,4
315106,315054,52,35,17,0,2,3
315231,315036,195,0,195,0,12,12
318262,318262,0,0,0,0,0,0
318732,318563,169,0,169,0,10,10
318242,318227,15,0,15,0,2,2
321537,321523,14,0,13,1,2,2
319573,319573,0,0,0,0,0,0
323093,323089,4,0,4,0,1,1
317984,317528,456,0,456,0,12,12
320809,320809,0,0,0,0,0,0
318158,317925,233,0,233,0,8,8
322279,322279,0,0,0,0,0,0
324497,324463,34,0,34,0,2,2
323339,323070,269,0,269,0,9,9
326791,326719,72,0,72,0,2,2
324535,324429,106,0,106,0,4,4
326326,326295,31,0,31,0,2,2
326528,326441,87,0,87,0,2,2
329989,329800,189,158,31,0,3,4
332758,332753,5,0,5,0,2,2
327909,327672,237,99,138,0,6,7
331203,330554,649,61,588,0,16,17
332754,332176,578,0,578,0,11,11
333987,333625,362,0,362,0,6,6
335180,334751,429,0,429,0,16,16
336781,336781,0,0,0,0,0,0
337191,336951,240,0,240,0,13,13
333060,332887,173,0,173,0,10,10
336531,336531,0,0,0,0,0,0
338627,338623,4,0,4,0,1,1
336404,336360,44,0,44,0,1,1
335839,335839,0,0,0,0,0,0
336317,336245,72,0,72,0,5,5
336789,336704,85,54,31,0,1,2
335434,335434,0,0,0,0,0,0
338772,338672,100,0,100,0,3,3
336993,336948,45,0,45,0,3,3
339094,338936,158,0,158,0,7,7
335075,334834,241,86,155,0,5,6
333214,333152,62,0,62,0,6,6
333768,333636,132,0,132,0,3,3
335219,335134,85,0,85,0,3,3
335592,335387,205,84,121,0,5,6
334379,334379,0,0,0,0,0,0
334818,334683,135,94,41,0,3,4
332514,332501,13,0,13,0,1,1
329573,329514,59,0,59,0,1,1
329792,329269,523,0,523,0,16,16
329305,329294,11,0,11,0,1,1
332769,332749,20,0,20,0,3,3
328879,328030,849,0,849,0,19,19
332746,331854,892,0,892,0,16,16
331656,331543,113,0,113,0,3,3
333892,333306,586,93,493,0,14,15
334443,334148,295,0,295,0,8,8
331205,330941,264,0,264,0,16,16
332363,331476,887,0,887,0,15,15
329999,329235,764,0,764,0,17,17
327989,327007,982,0,982,0,19,19
324847,324596,251,0,251,0,7,7
324909,323964,945,0,945,0,19,19
328810,328730,80,0,80,0,4,4
329147,327848,1299,182,1117,0,18,19
324953,324813,140,0,140,0,14,14
319815,319724,91,0,91,0,7,7
317678,317366,312,0,312,0,14,14
322064,321882,182,0,182,0,11,11
319394,319300,94,68,26,0,2,3
316095,315836,259,0,259,0,12,12
321475,321412,63,0,63,0,10,10
319831,318993,838,0,838,0,19,19
321980,321685,295,0,295,0,14,14
316335,315994,341,0,341,0,15,15
318745,318206,539,0,539,0,16,16
319856,319854,2,0,2,0,1,1
319150,319057,93,89,4,0,2,3
318997,318997,0,0,0,0,0,0
320970,320817,153,67,86,0,3,4
325160,324915,245,0,245,0,4,4
324112,323844,268,110,158,0,6,7
327541,327364,177,52,125,0,6,7
325624,325345,279,0,279,0,10,10
325375,325152,223,133,90,0,4,5
324293,323395,898,0,898,0,18,18
323674,323466,208,140,68,0,2,3
321035,320976,59,0,59,0,7,7
322461,322067,394,0,394,0,15,15
323186,323165,21,0,21,0,3,3
324155,324082,73,0,73,0,2,2
322360,322293,67,67,0,0,0,1
323121,323121,0,0,0,0,0,0
321978,321970,8,0,8,0,2,2
315388,315257,131,131,0,0,0,1
317602,317512,90,0,90,0,7,7
317004,316926,78,0,78,0,5,5
314337,314069,268,66,202,0,5,6
313775,313352,423,0,423,0,15,15
311972,311428,544,0,544,0,16,16
310801,310495,306,0,306,0,8,8
307856,307128,728,0,728,0,19,19
308889,308292,597,0,597,0,16,16
312485,311894,591,0,591,0,19,19
312245,312058,187,0,187,0,12,12
310912,310413,499,0,499,0,12,12
308901,308664,237,0,237,0,11,11
309062,309021,41,0,41,0,2,2
305616,305517,99,0,99,0,7,7
308828,308794,34,34,0,0,0,1
310641,310636,5,0,5,0,1,1
309874,309865,9,0,9,0,2,2
310387,310372,15,0,15,0,2,2
312046,312042,4,0,4,0,1,1
310997,310755,242,49,193,0,12,13
312330,312235,95,0,95,0,8,8
316574,316547,27,0,27,0,2,2
318611,318571,40,0,40,0,3,3
320391,320275,116,0,116,0,9,9
322820,322803,17,0,17,0,3,3
320664,320573,91,0,91,0,1,1
318761,318726,35,0,35,0,3,3
323258,323258,0,0,0,0,0,0
322406,322406,0,0,0,0,0,0
322667,322667,0,0,0,0,0,0
324403,323880,523,0,523,0,14,14
323197,323192,5,0,5,0,1,1
324782,324327,455,0,455,0,17,17
324995,324666,329,0,329,0,15,15
323381,323339,42,0,42,0,2,2
325993,325993,0,0,0,0,0,0
324748,324744,4,0,4,0,1,1
323758,323650,108,60,48,0,2,3
323405,323166,239,0,239,0,11,11
326702,326656,46,46,0,0,0,1
329661,329588,73,0,73,0,4,4
331451,331451,0,0,0,0,0,0
335894,335410,484,0,484,0,16,16
337249,337243,6,0,6,0,2,2
335097,335071,26,0,26,0,3,3
331743,331602,141,0,141,0,10,10
334404,334294,110,110,0,0,0,1
334613,334495,118,0,118,0,6,6
337633,337565,68,58,10,0,2,3
343573,343548,25,0,25,0,2,2
341733,341733,0,0,0,0,0,0
343146,343138,8,0,8,0,3,3
335895,335895,0,0,0,0,0,0
340621,340621,0,0,0,0,0,0
337432,337431,1,0,1,0,1,1
339231,339188,43,28,15,0,1,2
343351,343345,6,0,6,0,2,2
344883,344883,0,0,0,0,0,0
346812,346810,2,0,2,0,1,1
351130,351129,1,0,1,0,1,1
352035,352035,0,0,0,0,0,0
354271,354271,0,0,0,0,0,0
355609,355530,79,0,79,0,2,2
351564,351526,38,38,0,0,0,1
351065,351019,46,0,46,0,3,3
349558,349303,255,60,195,0,3,4
345930,345597,333,0,333,0,6,6
344738,344738,0,0,0,0,0,0
342951,342876,75,0,75,0,2,2
345172,345172,0,0,0,0,0,0
345553,345461,92,41,51,0,2,3
343743,343743,0,0,0,0,0,0
346662,346619,43,0,43,0,2,2
342791,342788,3,0,3,0,1,1
344867,344865,2,0,2,0,1,1
341978,341978,0,0,0,0,0,0
341444,341444,0,0,0,0,0,0
316816,316815,1,0,1,0,1,1
334231,334231,0,0,0,0,0,0
331526,331518,8,0,8,0,3,3
328213,328212,1,0,1,0,1,1
326578,326577,1,0,1,0,1,1
328520,328520,0,0,0,0,0,0
331823,331705,118,49,69,0,1,2
331630,331629,1,0,1,0,1,1
332316,332158,158,0,158,0,9,9
333403,333344,59,54,5,0,2,3
336083,335871,212,86,126,0,8,9
332826,332579,247,0,247,0,12,12
333236,333059,177,0,177,0,13,13
334112,334112,0,0,0,0,0,0
330642,330642,0,0,0,0,0,0
329654,329417,237,0,237,0,7,7
327300,327177,123,0,123,0,4,4
326403,325759,644,0,644,0,17,17
322384,322378,6,0,6,0,1,1
324974,324968,6,0,6,0,1,1
321783,321151,632,0,632,0,17,17
319635,319495,140,0,140,0,3,3
320908,320380,528,0,528,0,17,17
317584,317267,317,0,317,0,11,11
316271,316017,254,0,254,0,13,13
316465,316071,394,0,394,0,17,17
314026,313197,829,76,753,0,19,20
310089,309910,179,41,138,0,7,8
308694,308049,645,0,645,0,18,18
312167,311355,812,0,812,0,17,17
309297,308981,316,0,316,0,14,14
315388,315363,25,0,25,0,3,3
322522,322480,42,0,42,0,3,3
323561,323489,72,0,72,0,4,4
324318,323775,543,0,543,0,17,17
327163,327058,105,0,105,0,3,3
325304,325154,150,0,150,0,10,10
328182,327687,495,0,495,0,13,13
329116,329020,96,0,96,0,9,9
329509,328636,873,127,746,0,19,20
329522,329159,363,0,363,0,16,16
329709,329674,35,0,35,0,1,1
326299,326226,73,0,73,0,3,3
326290,326000,290,148,142,0,5,6
327810,327551,259,0,259,0,13,13
326427,326420,7,0,7,0,3,3
330011,329920,91,91,0,0,0,1
329883,329791,92,0,92,0,4,4
329038,329011,27,0,27,0,1,1
324658,324388,270,0,270,0,8,8
323111,322296,815,0,815,0,18,18
319648,319563,85,0,85,0,5,5
316675,316675,0,0,0,0,0,0
322196,321553,643,0,643,0,19,19
326043,326022,21,0,21,0,1,1
319667,318627,1040,0,1040,0,18,18
321466,321346,120,0,120,0,8,8
325887,325753,134,0,134,0,8,8
324745,324745,0,0,0,0,0,0
323132,323090,42,0,42,0,2,2
325417,325273,144,0,144,0,4,4
326241,326183,58,33,25,0,3,4
326402,325656,746,63,683,0,15,16
325382,324793,589,82,507,0,17,18
326566,325966,600,0,600,0,15,15
324122,324122,0,0,0,0,0,0
325807,325547,260,0,260,0,16,16
321195,321118,77,77,0,0,0,1
319447,319281,166,82,84,0,5,6
311271,310799,472,0,472,0,15,15
310832,310467,365,0,365,0,15,15
303781,303482,299,0,299,0,14,14
302178,302177,1,0,1,0,1,1
305089,304845,244,0,244,0,13,13
303125,302858,267,0,267,0,13,13
303318,303173,145,0,145,0,6,6
300732,300653,79,0,79,0,3,3
302695,302685,10,0,10,0,2,2
303955,303782,173,13,160,0,12,13
303045,303038,7,0,7,0,2,2
303387,303385,2,0,2,0,1,1
300633,300340,293,0,293,0,13,13
302756,302755,1,0,1,0,1,1
307006,307006,0,0,0,0,0,0
308156,307910,246,0,246,0,10,10
311466,310833,633,0,633,0,19,19
313261,312669,592,0,592,0,17,17
314017,313205,812,0,812,0,19,19
316060,315912,148,0,148,0,9,9
322378,322371,7,0,7,0,2,2
325546,325208,338,0,338,0,14,14
324735,324629,106,0,106,0,4,4
324748,324703,45,0,45,0,2,2
322198,321387,811,33,778,0,18,19
322905,322768,137,0,137,0,7,7
323848,323847,1,0,1,0,1,1
322682,322485,197,0,197,0,5,5
325784,325706,78,0,78,0,12,12
327766,327655,111,0,111,0,8,8
325071,325071,0,0,0,0,0,0
321178,320989,189,0,189,0,10,10
320230,319928,302,0,302,0,10,10
323086,322901,185,0,185,0,11,11
318759,318698,61,61,0,0,0,1
320091,319748,343,0,343,0,13,13
320353,320049,304,0,304,0,12,12
323538,323466,72,31,41,0,3,4
325533,325158,375,0,375,0,15,15
327750,327723,27,0,27,0,3,3
329145,328806,339,52,287,0,14,15
330555,330187,368,0,368,0,11,11
332129,331640,489,0,489,0,17,17
331274,331200,74,0,74,0,10,10
329619,329466,153,0,153,0,4,4
327285,326867,418,0,418,0,18,18
332034,331969,65,29,36,0,1,2
331115,330695,420,0,420,0,17,17
330113,329940,173,0,173,0,12,12
329756,329694,62,0,62,0,1,1
333457,333392,65,0,65,0,2,2
327638,327638,0,0,0,0,0,0
330312,330312,0,0,0,0,0,0
325010,324957,53,0,53,0,3,3
321902,321286,616,0,616,0,19,19
321327,321327,0,0,0,0,0,0
314935,314872,63,43,20,0,1,2
318649,318472,177,0,177,0,8,8
322290,322131,159,0,159,0,7,7
321214,321059,155,58,97,0,3,4
320396,320355,41,0,41,0,3,3
321916,321780,136,27,109,0,5,6
319796,319414,382,0,382,0,15,15
318028,317969,59,0,59,0,2,2
320924,320791,133,110,23,0,2,3
321796,321796,0,0,0,0,0,0
323930,323930,0,0,0,0,0,0
324880,324835,45,0,45,0,3,3
325681,325681,0,0,0,0,0,0
323886,323873,13,0,13,0,1,1
321718,321639,79,0,79,0,3,3
324047,323833,214,0,214,0,13,13
326720,326488,232,55,177,0,13,14
325529,325521,8,0,8,0,1,1
321051,320927,124,0,124,0,5,5
319587,319467,120,0,120,0,8,8
323834,323831,3,0,3,0,1,1
317852,317728,124,80,44,0,5,6
314326,314289,37,0,37,0,3,3
321393,321286,107,0,107,0,3,3
323463,323228,235,130,105,0,2,3
323036,322843,193,78,115,0,10,11
319533,319376,157,0,157,0,12,12
321613,321581,32,0,32,0,5,5
320642,320381,261,0,261,0,12,12
319816,319664,152,0,152,0,6,6
329199,329128,71,0,71,0,4,4
331363,331043,320,88,232,0,5,6
329932,329530,402,0,402,0,16,16
332512,332139,373,0,373,0,15,15
330406,330310,96,48,48,0,2,3
333010,332864,146,0,146,0,8,8
334446,334069,377,0,377,0,16,16
341129,341072,57,0,57,0,6,6
339756,339615,141,0,141,0,2,2
345043,344984,59,0,59,0,5,5
340947,340911,36,0,36,0,6,6
340974,340966,8,0,8,0,2,2
341697,341697,0,0,0,0,0,0
341740,341686,54,17,37,0,4,5
343262,343020,242,0,242,0,13,13
340079,339940,139,43,96,0,4,5
340391,340391,0,0,0,0,0,0
339773,339711,62,0,62,0,6,6
344250,344171,79,0,79,0,4,4
346948,346923,25,0,25,0,1,1
346341,346303,38,0,38,0,2,2
345681,345668,13,0,13,0,2,2
342259,342259,0,0,0,0,0,0
342891,342890,1,0,1,0,1,1
340410,340410,0,0,0,0,0,0
340201,340037,164,128,36,0,1,2
343623,343265,358,51,307,0,11,12
341693,341177,516,52,464,0,11,12
337847,336381,1466,0,1466,0,19,19
340036,339843,193,0,193,0,12,12
343561,343435,126,0,126,0,7,7
341789,341654,135,0,135,0,2,2
343381,342624,757,0,757,0,18,18
343383,342706,677,0,677,0,18,18
344962,344962,0,0,0,0,0,0
340961,340644,317,0,317,0,13,13
340475,340408,67,65,2,0,1,2
343579,343497,82,61,21,0,2,3
345001,344768,233,132,101,0,5,6
344821,344810,11,0,11,0,2,2
343999,343998,1,0,1,0,1,1
345179,345083,96,0,96,0,2,2
347067,346795,272,71,201,0,5,6
347373,347305,68,68,0,0,0,1
348916,348812,104,1,103,0,5,6
345265,345263,2,0,2,0,1,1
344137,344137,0,0,0,0,0,0
340252,340211,41,40,1,0,1,2
337982,337926,56,0,56,0,3,3
332819,332717,102,0,102,0,4,4
333705,333660,45,0,45,0,4,4
328313,328265,48,48,0,0,0,1
325670,325640,30,0,30,0,4,4
324431,324360,71,0,71,0,7,7
321305,321302,3,0,3,0,1,1
321877,321877,0,0,0,0,0,0
327546,327345,201,0,201,0,11,11
327734,327612,122,52,70,0,1,2
324967,324941,26,0,26,0,2,2
323170,322884,286,0,286,0,9,9
321517,321172,345,0,345,0,12,12
322764,322710,54,0,54,0,3,3
322642,322632,10,0,10,0,1,1
323699,323015,684,61,623,0,18,19
318379,318182,197,0,197,0,11,11
317791,317760,31,0,31,0,3,3
322486,322478,8,0,8,0,1,1
326278,326056,222,0,222,0,8,8
332213,331942,271,0,271,0,12,12
335324,335299,25,0,25,0,2,2
335991,335991,0,0,0,0,0,0
330857,330711,146,77,69,0,2,3
327897,327897,0,0,0,0,0,0
326954,326954,0,0,0,0,0,0
323807,323800,7,0,7,0,1,1
325089,325065,24,0,24,0,3,3
321596,321559,37,0,37,0,4,4
315975,315975,0,0,0,0,0,0
313550,313550,0,0,0,0,0,0
309253,308667,586,82,504,0,13,14
308585,308585,0,0,0,0,0,0
310923,310900,23,0,23,0,1,1
310765,310733,32,32,0,0,0,1
310105,309999,106,0,106,0,10,10
307406,307391,15,0,15,0,2,2
304648,304645,3,0,3,0,1,1
303162,302996,166,0,166,0,8,8
306985,306931,54,0,54,0,6,6
307291,307241,50,40,10,0,3,4
306052,305825,227,0,227,0,15,15
303544,303463,81,0,81,0,7,7
305401,305088,313,0,313,0,16,16
303623,303556,67,67,0,0,0,1
303080,303017,63,0,63,0,4,4
302788,302662,126,0,126,0,5,5
300518,300474,44,0,44,0,5,5
299701,299701,0,0,0,0,0,0
298259,298259,0,0,0,0,0,0
299102,298871,231,65,166,0,9,10
294458,294243,215,0,215,0,11,11
293797,293775,22,0,22,0,1,1
291743,291741,2,0,2,0,1,1
290880,290860,20,0,20,0,2,2
289381,289315,66,50,16,0,3,4
286956,286865,91,65,26,0,2,3
284358,284288,70,67,3,0,1,2
274792,274786,6,0,6,0,1,1
274398,274292,106,0,106,0,7,7
274562,274544,18,0,18,0,1,1
274470,274470,0,0,0,0,0,0
279440,278364,1076,0,1076,0,18,18
279948,279834,114,0,114,0,7,7
281372,281330,42,39,3,0,1,2
279107,279083,24,0,24,0,2,2
278687,277962,725,0,725,0,16,16
278367,278154,213,73,140,0,7,8
275829,275774,55,34,21,0,2,3
276861,276024,837,0,837,0,19,19
276145,276067,78,0,78,0,8,8
276849,276687,162,62,100,0,4,5
276605,276585,20,0,20,0,2,2
280804,280765,39,0,39,0,1,1
281174,280803,371,0,371,0,13,13
281990,281204,786,0,786,0,19,19
282591,281960,631,0,631,0,19,19
283325,283135,190,0,190,0,12,12
281624,281428,196,0,196,0,11,11
281967,281354,613,0,613,0,17,17
286610,286535,75,0,75,0,6,6
285102,285014,88,0,88,0,3,3
285257,285228,29,0,29,0,5,5
287143,286989,154,0,154,0,10,10
288520,288349,171,106,65,0,4,5
287041,287034,7,0,7,0,2,2
288752,288682,70,0,70,0,7,7
286919,286817,102,75,27,0,1,2
284256,284150,106,0,106,0,9,9
283004,282993,11,0,11,0,1,1
283788,283698,90,68,22,0,2,3
287163,286906,257,0,257,0,2,2
288340,288142,198,86,112,0,9,10
290729,290689,40,0,40,0,3,3
285134,285018,116,0,116,0,9,9
283029,283007,22,0,22,0,5,5
285127,285124,3,0,3,0,2,2
277809,277465,344,0,344,0,15,15
280805,280783,22,0,22,0,6,6
280325,280043,282,5,277,0,13,14
280093,280093,0,0,0,0,0,0
271539,271539,0,0,0,0,0,0
268637,268602,35,0,35,0,1,1
272296,272296,0,0,0,0,0,0
266390,266368,22,22,0,0,0,1
264170,264170,0,0,0,0,0,0
264826,264813,13,0,13,0,3,3
268518,268472,46,46,0,0,0,1
268373,268373,0,0,0,0,0,0
268806,268806,0,0,0,0,0,0
270020,269948,72,72,0,0,0,1
269060,269035,25,0,25,0,2,2
267353,267336,17,0,17,0,1,1
268026,268026,0,0,0,0,0,0
268472,268357,115,53,62,0,1,2
269097,268974,123,0,123,0,1,1
269526,269504,22,0,22,0,3,3
272067,272067,0,0,0,0,0,0
274004,274004,0,0,0,0,0,0
274341,274253,88,0,88,0,3,3
274209,274190,19,0,19,0,2,2
275794,275672,122,0,122,0,4,4
275745,275677,68,45,23,0,2,3
275815,275746,69,0,69,0,4,4
279218,279044,174,64,110,0,3,4
279373,279240,133,0,133,0,3,3
282815,282543,272,108,164,0,7,8
284463,284356,107,0,107,0,7,7
285906,285761,145,0,145,0,6,6
282995,282984,11,0,11,0,2,2
285543,285429,114,0,114,0,7,7
287141,286985,156,0,156,0,12,12
287371,287304,67,0,67,0,2,2
288566,288560,6,0,6,0,2,2
293118,293059,59,28,31,0,3,4
294416,294392,24,0,24,0,2,2
291570,290978,592,0,592,0,17,17
293132,293066,66,0,66,0,2,2
297216,297033,183,71,112,0,8,9
297422,297360,62,0,62,0,2,2
299912,299851,61,0,61,0,3,3
297398,297398,0,0,0,0,0,0
299856,299851,5,0,5,0,1,1
298609,298609,0,0,0,0,0,0
296266,296266,0,0,0,0,0,0
296939,296938,1,0,1,0,1,1
296515,296389,126,0,126,0,4,4
296705,296526,179,0,179,0,2,2
293783,293771,12,0,12,0,1,1
292998,292919,79,60,19,0,3,4
290856,290856,0,0,0,0,0,0
289233,289039,194,0,194,0,10,10
292398,292140,258,0,258,0,6,6
293200,293026,174,0,174,0,14,14
291304,291218,86,0,86,0,4,4
295266,295263,3,0,3,0,2,2
293519,293217,302,0,302,0,7,7
292366,292012,354,33,321,0,13,14
291707,291495,212,37,175,0,15,16
291599,291515,84,72,12,0,3,4
289159,289114,45,0,45,0,2,2
289631,289054,577,0,577,0,18,18
287992,287724,268,0,268,0,10,10
287097,287043,54,0,54,0,1,1
287519,287148,371,0,371,0,17,17
289214,288533,681,0,681,0,18,18
287102,287102,0,0,0,0,0,0
287115,287092,23,0,23,0,1,1
291305,291166,139,54,85,0,2,3
286657,286305,352,0,352,0,16,16
285696,285595,101,0,101,0,2,2
285399,285399,0,0,0,0,0,0
284768,284768,0,0,0,0,0,0
280597,280423,174,0,174,0,9,9
278254,278246,8,0,8,0,3,3
278202,278195,7,0,7,0,2,2
273960,273729,231,0,231,0,6,6
274561,274177,384,0,384,0,16,16
274148,273516,632,0,632,0,18,18
275659,275570,89,0,89,0,2,2
274410,274319,91,0,91,0,12,12
270953,270858,95,0,95,0,12,12
268645,268619,26,0,26,0,3,3
267364,267300,64,0,64,0,3,3
267405,267355,50,0,50,0,1,1
267594,266819,775,0,775,0,18,18
262924,262904,20,0,20,0,3,3
259813,259705,108,0,108,0,5,5
262592,262554,38,0,38,0,4,4
259284,259284,0,0,0,0,0,0
259910,259887,23,22,1,0,1,2
255829,255816,13,0,13,0,3,3
255931,255831,100,79,21,0,1,2
253217,253174,43,0,43,0,2,2
252422,252422,0,0,0,0,0,0
253720,253652,68,68,0,0,0,1
250617,250603,14,0,14,0,3,3
250717,250717,0,0,0,0,0,0
245963,245859,104,0,104,0,2,2
247286,247127,159,0,159,0,11,11
244239,244132,107,0,107,0,2,2
243138,243138,0,0,0,0,0,0
243950,243920,30,0,30,0,1,1
242425,242416,9,4,5,0,1,2
241642,241578,64,0,64,0,2,2
245213,245212,1,0,1,0,1,1
247795,247795,0,0,0,0,0,0
249202,249202,0,0,0,0,0,0
249992,249945,47,0,47,0,2,2
251744,251708,36,0,36,0,3,3
253576,253545,31,0,31,0,2,2
254358,254176,182,0,182,0,9,9
259474,259438,36,0,36,0,5,5
261117,261091,26,0,26,0,2,2
262625,262270,355,0,355,0,15,15
267399,267398,1,0,1,0,1,1
266103,266063,40,40,0,0,0,1
267441,267430,11,0,11,0,2,2
269486,269371,115,115,0,0,0,1
272288,272252,36,0,36,0,1,1
272915,272910,5,0,5,0,1,1
275302,275289,13,0,13,0,2,2
283624,283613,11,0,11,0,3,3
289221,289093,128,0,128,0,4,4
290654,290541,113,0,113,0,7,7
303934,303548,386,0,386,0,15,15
306498,306498,0,0,0,0,0,0
311943,311654,289,0,289,0,13,13
325437,325184,253,0,253,0,13,13
330463,330456,7,0,7,0,1,1
337190,337122,68,0,68,0,3,3
349483,349062,421,112,309,0,12,13
352603,352501,102,58,44,0,5,6
356039,356006,33,27,6,0,1,2
358960,358959,1,0,1,0,1,1
363588,362872,716,41,675,0,17,18
374269,374166,103,65,38,0,3,4
381028,381028,0,0,0,0,0,0
380318,380293,25,0,25,0,1,1
381364,381361,3,0,3,0,1,1
385198,384929,269,0,269,0,5,5
390272,390243,29,0,29,0,1,1
392645,392415,230,0,230,0,12,12
392634,391434,1200,0,1200,0,19,19
399620,399365,255,0,255,0,12,12
407688,407688,0,0,0,0,0,0
408366,407895,471,0,471,0,14,14
410756,410311,445,0,445,0,13,13
416028,416017,11,0,11,0,1,1
420057,419749,308,0,308,0,6,6
428119,427629,490,44,446,0,11,12
427008,426879,129,0,129,0,10,10
430217,430192,25,0,25,0,1,1
433250,433102,148,132,16,0,1,2
427160,426919,241,84,157,0,7,8
433533,433431,102,0,102,0,7,7
430701,430643,58,0,58,0,8,8
434409,434313,96,0,96,0,3,3
434322,434322,0,0,0,0,0,0
436519,436463,56,0,56,0,4,4
442072,441945,127,0,127,0,5,5
439932,439709,223,47,176,0,4,5
547052,546005,1047,0,1047,0,18,18
545442,545158,284,251,33,0,2,3
538842,538842,0,0,0,0,0,0
545079,544828,251,0,251,0,10,10
539727,539399,328,0,328,0,3,3
557577,557245,332,90,242,0,4,5
548062,547663,399,0,399,0,11,11
557007,556908,99,96,3,0,1,2
554462,554393,69,69,0,0,0,1
557364,557323,41,15,26,0,2,3
546261,545957,304,0,304,0,11,11
561220,561192,28,0,28,0,1,1
556405,556260,145,75,70,0,5,6
552813,552767,46,0,46,0,1,1
553234,552808,426,39,387,0,10,11
554493,554493,0,0,0,0,0,0
