"POSITION","REF_CODON","CODON","REF_AA","AA","FWD_CNT","FWD_DENOM","REV_CNT","REV_DENOM","CNT","DENOM","std.bias","id"
1,"CAT","AAT","H","N",12,149828,6,69966,18,219794,0.560841984653923,1
1,"CAT","CAA","H","Q",0,149828,1,69966,1,219794,1.43937961454712,2
1,"CAT","CAC","H","H",2,149828,0,69966,2,219794,1.08610220854844,3
1,"CAT","CAT","H","H",149810,149828,69959,69966,219769,219794,1,4
1,"CAT","CTT","H","L",1,149828,0,69966,1,219794,0.627174395665805,5
1,"CAT","GAT","H","D",2,149828,0,69966,2,219794,1.08610220854844,6
1,"CAT","TAT","H","Y",1,149828,0,69966,1,219794,0.627174395665805,7
2,"AGA","AAA","R","K",1,141514,0,79194,1,220708,0.812087181580927,8
2,"AGA","ACA","R","T",2,141514,0,79194,2,220708,1.33982114900625,9
2,"AGA","AGA","R","R",141486,141514,79175,79194,220661,220708,1,10
2,"AGA","AGC","R","S",1,141514,0,79194,1,220708,0.812087181580927,11
2,"AGA","AGG","R","R",1,141514,3,79194,4,220708,1.46166876681621,12
2,"AGA","ATA","R","I",12,141514,10,79194,22,220708,0.36281952617604,13
2,"AGA","CGA","R","R",1,141514,1,79194,2,220708,0.272429721698167,14
2,"AGA","GGA","R","G",10,141514,4,79194,14,220708,0.922531879743991,15
2,"AGA","TGA","R",".",0,141514,1,79194,1,220708,1.46166876681621,16
3,"CAT","AAT","H","N",7,129563,9,89243,16,218806,0.711409035507709,17
3,"CAT","CAA","H","Q",1,129563,0,89243,1,218806,1.06382654569337,18
3,"CAT","CAC","H","H",0,129563,3,89243,3,218806,2.80180518704499,19
3,"CAT","CAT","H","H",129552,129563,89227,89243,218779,218806,1,20
3,"CAT","CGT","H","R",1,129563,4,89243,5,218806,1.90573664133886,21
3,"CAT","TAT","H","Y",2,129563,0,89243,2,218806,1.66188484942895,22
4,"AGC","AAC","S","N",4,119781,0,97905,4,217686,2.87384628025483,23
4,"AGC","ACC","S","T",0,119781,1,97905,1,217686,1.54077343623674,24
4,"AGC","AGA","S","R",6,119781,9,97905,15,217686,0.996585379332255,25
4,"AGC","AGC","S","S",119726,119781,97868,97905,217594,217686,1,26
4,"AGC","AGG","S","R",0,119781,2,97905,2,217686,2.26884209043986,27
4,"AGC","AGT","S","S",22,119781,11,97905,33,217686,1.23973702645386,28
4,"AGC","ATC","S","I",12,119781,11,97905,23,217686,0.578973652535971,29
4,"AGC","CGC","S","R",2,119781,0,97905,2,217686,1.94787890508605,30
4,"AGC","GGC","S","G",9,119781,2,97905,11,217686,2.13113678054959,31
4,"AGC","TGC","S","C",0,119781,1,97905,1,217686,1.54077343623674,32
5,"GTG","ATG","V","M",5,112856,9,110926,14,223782,1.32009892535416,33
5,"GTG","GCG","V","A",1,112856,0,110926,1,223782,1.58187260601773,34
5,"GTG","GTA","V","V",0,112856,1,110926,1,223782,1.60261749358348,35
5,"GTG","GTG","V","V",112835,112856,110901,110926,223736,223782,1,36
5,"GTG","GTT","V","V",9,112856,11,110926,20,223782,0.877971410173353,37
5,"GTG","TTG","V","L",6,112856,4,110926,10,223782,1.06242789767188,38
6,"GGG","AGG","G","R",2,105134,7,116562,9,221696,1.91472227206029,39
6,"GGG","CGG","G","R",0,105134,1,116562,1,221696,1.44788156694109,40
6,"GGG","GAG","G","E",4,105134,3,116562,7,221696,0.865428181714469,41
6,"GGG","GGA","G","G",1,105134,0,116562,1,221696,1.5714292978761,42
6,"GGG","GGC","G","G",2,105134,2,116562,4,221696,0.595271493500614,43
6,"GGG","GGG","G","G",105084,105134,116507,116562,221591,221696,1,44
6,"GGG","GGT","G","G",33,105134,29,116562,62,221696,0.74096910582625,45
6,"GGG","GTG","G","V",2,105134,6,116562,8,221696,1.69178849148077,46
6,"GGG","TGG","G","W",6,105134,7,116562,13,221696,0.723948396991424,47
7,"ACC","AAC","T","N",3,95925,3,125169,6,221094,0.462054273257544,48
7,"ACC","ACA","T","T",5,95925,8,125169,13,221094,0.84221170366765,49
7,"ACC","ACC","T","T",95904,95925,125140,125169,221044,221094,1,50
7,"ACC","ACG","T","T",2,95925,0,125169,2,221094,2.26044258641227,51
7,"ACC","ACT","T","T",4,95925,6,125169,10,221094,0.766011714238251,52
7,"ACC","AGC","T","S",1,95925,2,125169,3,221094,0.84221170366765,53
7,"ACC","ATC","T","I",2,95925,7,125169,9,221094,1.64414445275698,54
7,"ACC","GCC","T","A",4,95925,3,125169,7,221094,0.765389443967189,55
8,"ACG","AAG","T","K",1,85341,7,135332,8,220673,1.9965655326303,56
8,"ACG","ACA","T","T",30,85341,54,135332,84,220673,0.8118044877077,57
8,"ACG","ACC","T","T",3,85341,1,135332,4,220673,1.48108909782312,58
8,"ACG","ACG","T","T",85287,85341,135235,135332,220522,220673,1,59
8,"ACG","ACT","T","T",10,85341,16,135332,26,220673,0.667807043205717,60
8,"ACG","ATG","T","M",9,85341,18,135332,27,220673,0.890281325390922,61
8,"ACG","GCG","T","A",1,85341,1,135332,2,220673,0.334851377133812,62
9,"CTT","ATT","L","I",5,70794,15,147490,20,218284,0.970169163614086,63
9,"CTT","CCT","L","P",1,70794,4,147490,5,218284,0.891994704253376,64
9,"CTT","CTA","L","L",1,70794,0,147490,1,218284,1.44229624346233,65
9,"CTT","CTC","L","L",4,70794,4,147490,8,218284,0.207338261574578,66
9,"CTT","CTT","L","L",70782,70794,147464,147490,218246,218284,1,67
9,"CTT","TTT","L","F",1,70794,3,147490,4,218284,0.653155462094227,68
10,"GAG","AAG","E","K",1,61639,2,162089,3,223728,0.281717006438523,69
10,"GAG","GAA","E","E",1,61639,4,162089,5,223728,0.643903810290372,70
10,"GAG","GAG","E","E",61620,61639,162034,162089,223654,223728,1,71
10,"GAG","GAT","E","D",3,61639,17,162089,20,223728,1.36829134394644,72
10,"GAG","GGG","E","G",5,61639,14,162089,19,223728,0.643903810290372,73
10,"GAG","GTG","E","V",2,61639,6,162089,8,223728,0.580759997880031,74
10,"GAG","TAG","E",".",7,61639,12,162089,19,223728,0.323457384226505,75
11,"GCA","ACA","A","T",14,57235,24,167781,38,225016,0.280026293518189,76
11,"GCA","GAA","A","E",8,57235,20,167781,28,225016,0.490665336547029,77
11,"GCA","GCA","A","A",57198,57235,167696,167781,224894,225016,1,78
11,"GCA","GCC","A","A",0,57235,1,167781,1,225016,0.38209891765628,79
11,"GCA","GCG","A","A",0,57235,2,167781,2,225016,0.716401350407243,80
11,"GCA","GGA","A","G",0,57235,1,167781,1,225016,0.38209891765628,81
11,"GCA","GTA","A","V",8,57235,22,167781,30,225016,0.565197829445255,82
11,"GCA","TCA","A","S",7,57235,15,167781,22,225016,0.38209891765628,83
12,"CTG","ATG","L","M",1,21754,3,171002,4,192756,0.0627294335327747,84
12,"CTG","CAG","L","Q",0,21754,2,171002,2,192756,0.135982736022188,85
12,"CTG","CCG","L","P",0,21754,2,171002,2,192756,0.135982736022188,86
12,"CTG","CTA","L","L",1,21754,4,171002,5,192756,0.0963589445186593,87
12,"CTG","CTG","L","L",21749,21754,170964,171002,192713,192756,1,88
12,"CTG","CTT","L","L",2,21754,12,171002,14,192756,0.265369216969981,89
12,"CTG","GTG","L","V",0,21754,3,171002,3,192756,0.230281909024006,90
12,"CTG","TTG","L","L",1,21754,12,171002,13,192756,0.521054750584586,91
13,"TTC","ATC","F","I",1,22460,0,169281,1,191741,1.39068774101743,92
13,"TTC","CTC","F","L",0,22460,1,169281,1,191741,0.0680779241526078,93
13,"TTC","GTC","F","V",0,22460,22,169281,22,191741,2.33377781139594,94
13,"TTC","TCC","F","S",1,22460,1,169281,2,191741,0.0174588826354287,95
13,"TTC","TTA","F","L",1,22460,25,169281,26,191741,1.38039156870996,96
13,"TTC","TTC","F","F",22457,22460,169224,169281,191681,191741,1,97
13,"TTC","TTG","F","L",0,22460,2,169281,2,191741,0.147134366829079,98
13,"TTC","TTT","F","F",0,22460,6,169281,6,191741,0.622186378369597,99
14,"CAG","AAG","Q","K",3,23734,7,172698,10,196432,0.0727565611172122,100
14,"CAG","CAA","Q","Q",0,23734,8,172698,8,196432,0.927523826359737,101
14,"CAG","CAC","Q","H",1,23734,0,172698,1,196432,1.39100006529086,102
14,"CAG","CAG","Q","Q",23706,23734,172592,172698,196298,196432,1,103
14,"CAG","CAT","Q","H",1,23734,14,172698,15,196432,0.72332642691046,104
14,"CAG","CCG","Q","P",4,23734,4,172698,8,196432,0.0186913959276449,105
14,"CAG","CGG","Q","R",16,23734,55,172698,71,196432,0.186256871934299,106
14,"CAG","CTG","Q","L",2,23734,10,172698,12,196432,0.226066209336887,107
14,"CAG","TAG","Q",".",1,23734,8,172698,9,196432,0.323575330849541,108
15,"GGA","AGA","G","R",2,24805,4,174442,6,199247,0.0546366358609134,109
15,"GGA","GAA","G","E",0,24805,9,174442,9,199247,1.10580102634551,110
15,"GGA","GCA","G","A",0,24805,1,174442,1,199247,0.0777623465252041,111
15,"GGA","GGA","G","G",24792,24805,174371,174442,199163,199247,1,112
15,"GGA","GGG","G","G",1,24805,2,174442,3,199247,0.0444827941954309,113
15,"GGA","GTA","G","V",9,24805,46,174442,55,199247,0.369202938609009,114
15,"GGA","TGA","G",".",1,24805,9,174442,10,199247,0.409065936676629,115
16,"CCA","ACA","P","T",3,26542,10,176303,13,202845,0.15818467500784,116
16,"CCA","CAA","P","Q",4,26542,12,176303,16,202845,0.142537326948773,117
16,"CCA","CCA","P","P",26534,26542,176265,176303,202799,202845,1,118
16,"CCA","CCG","P","P",0,26542,2,176303,2,202845,0.185615574399798,119
16,"CCA","CGA","P","R",0,26542,1,176303,1,202845,0.0867725605025479,120
16,"CCA","CTA","P","L",1,26542,7,176303,8,202845,0.309390514701569,121
16,"CCA","TCA","P","S",0,26542,6,176303,6,202845,0.74689896219023,122
17,"CCA","ACA","P","T",0,27439,7,176300,7,203739,0.936235280376475,123
17,"CCA","CAA","P","Q",1,27439,9,176300,10,203739,0.473503825691348,124
17,"CCA","CCA","P","P",27434,27439,176269,176300,203703,203739,1,125
17,"CCA","CCG","P","P",2,27439,3,176300,5,203739,0.0421640781831484,126
17,"CCA","CCT","P","P",0,27439,2,176300,2,203739,0.197226298606737,127
17,"CCA","CGA","P","R",0,27439,2,176300,2,203739,0.197226298606737,128
17,"CCA","CTA","P","L",0,27439,5,176300,5,203739,0.6270493550996,129
17,"CCA","GCA","P","A",1,27439,0,176300,1,203739,1.39233219791111,130
17,"CCA","TCA","P","S",1,27439,3,176300,4,203739,0.0924858499527547,131
18,"GTA","ATA","V","I",2,29937,6,175542,8,205479,0.146972889716551,132
18,"GTA","CTA","V","L",0,29937,1,175542,1,205479,0.110036321080934,133
18,"GTA","GAA","V","E",0,29937,8,175542,8,205479,1.21058647560741,134
18,"GTA","GCA","V","A",1,29937,1,175542,2,205479,0.0286648628990702,135
18,"GTA","GTA","V","V",29930,29937,175519,175542,205449,205479,1,136
18,"GTA","GTC","V","V",0,29937,2,175542,2,205479,0.232473400716883,137
18,"GTA","GTG","V","V",1,29937,0,175542,1,205479,1.39353797615658,138
18,"GTA","GTT","V","V",2,29937,0,175542,2,205479,2.20045044129389,139
18,"GTA","TTA","V","L",1,29937,5,175542,6,205479,0.232473400716883,140
19,"TAC","GAC","Y","D",0,31187,1,174001,1,205188,0.120874997298463,141
19,"TAC","TAA","Y",".",4,31187,7,174001,11,205188,0.0790234107797178,142
19,"TAC","TAC","Y","Y",31179,31187,173972,174001,205151,205188,1,143
19,"TAC","TAT","Y","Y",2,31187,17,174001,19,205188,0.768419092306507,144
19,"TAC","TGC","Y","C",1,31187,2,174001,3,205188,0.0697799110347686,145
19,"TAC","TTC","Y","F",1,31187,2,174001,3,205188,0.0697799110347686,146
20,"AGA","AAA","R","K",0,33265,2,175639,2,208904,0.279724900491019,147
20,"AGA","ACA","R","T",2,33265,2,175639,4,208904,0.0352347745060957,148
20,"AGA","AGA","R","R",33254,33265,175603,175639,208857,208904,1,149
20,"AGA","AGG","R","R",0,33265,5,175639,5,208904,0.829016111578473,150
20,"AGA","AGT","R","S",0,33265,1,175639,1,208904,0.134051318010308,151
20,"AGA","ATA","R","I",7,33265,25,175639,32,208904,0.32121472433141,152
20,"AGA","GGA","R","G",1,33265,1,175639,2,208904,0.0352347745060957,153
20,"AGA","TGA","R",".",1,33265,0,175639,1,208904,1.39522012630682,154
21,"GAG","AAG","E","K",1,34622,1,172935,2,207557,0.0393061810437969,155
21,"GAG","CAG","E","Q",0,34622,1,172935,1,207557,0.148726476787998,156
21,"GAG","GAA","E","E",1,34622,0,172935,1,207557,1.39626669430643,157
21,"GAG","GAC","E","D",0,34622,1,172935,1,207557,0.148726476787998,158
21,"GAG","GAG","E","E",34616,34622,172892,172935,207508,207557,1,159
21,"GAG","GAT","E","D",2,34622,16,172935,18,207557,0.827371564182591,160
21,"GAG","GCG","E","A",0,34622,2,172935,2,207557,0.308072772124852,161
21,"GAG","GGG","E","G",0,34622,3,172935,3,207557,0.495563089475787,162
21,"GAG","TAG","E",".",2,34622,19,172935,21,207557,1.02307248357292,163
22,"ATC","ACC","I","T",0,35984,5,170145,5,206129,0.959524292316255,164
22,"ATC","ATA","I","I",2,35984,17,170145,19,206129,0.959524292316255,165
22,"ATC","ATC","I","I",35980,35984,170117,170145,206097,206129,1,166
22,"ATC","ATG","I","M",0,35984,3,170145,3,206129,0.539854671422856,167
22,"ATC","ATT","I","I",2,35984,2,170145,4,206129,0.0437631149105349,168
22,"ATC","GTC","I","V",0,35984,1,170145,1,206129,0.164615198576968,169
23,"AAA","AAA","K","K",37832,37833,164442,164449,202274,202282,1,170
23,"AAA","AAG","K","K",0,37833,1,164449,1,202282,0.192044412306275,171
23,"AAA","AAT","K","N",0,37833,1,164449,1,202282,0.192044412306275,172
23,"AAA","ATA","K","I",0,37833,1,164449,1,202282,0.192044412306275,173
23,"AAA","GAA","K","E",1,37833,4,164449,5,202282,0.285794743240147,174
24,"ATT","ACT","I","T",0,40360,2,161385,2,201745,0.4466039037473,175
24,"ATT","ATA","I","I",0,40360,3,161385,3,201745,0.693587155014842,176
24,"ATT","ATG","I","M",0,40360,5,161385,5,201745,1.17926414020979,177
24,"ATT","ATT","I","I",40360,40360,161372,161385,201732,201745,1,178
24,"ATT","CTT","I","L",0,40360,3,161385,3,201745,0.693587155014842,179
25,"AGC","AAC","S","N",0,41649,2,159614,2,201263,0.477840972154356,180
25,"AGC","ACC","S","T",0,41649,2,159614,2,201263,0.477840972154356,181
25,"AGC","AGA","S","R",6,41649,15,159614,21,201263,0.3042494937955,182
25,"AGC","AGC","S","S",41611,41649,159497,159614,201108,201263,1,183
25,"AGC","AGG","S","R",2,41649,0,159614,2,201263,2.20475894989653,184
25,"AGC","AGT","S","S",19,41649,80,159614,99,201263,0.74973707731565,185
25,"AGC","ATC","S","I",5,41649,14,159614,19,201263,0.354458817577011,186
25,"AGC","GGC","S","G",6,41649,4,159614,10,201263,0.707082356544755,187
26,"GTT","ATT","V","I",3,42169,6,156944,9,199113,0.199750515665224,188
26,"GTT","CTT","V","L",0,42169,1,156944,1,199113,0.253696934208996,189
26,"GTT","GCT","V","A",0,42169,1,156944,1,199113,0.253696934208996,190
26,"GTT","GGT","V","G",0,42169,2,156944,2,199113,0.500628373536769,191
26,"GTT","GTC","V","V",0,42169,1,156944,1,199113,0.253696934208996,192
26,"GTT","GTT","V","V",42164,42169,156926,156944,199090,199113,1,193
26,"GTT","TTT","V","F",2,42169,7,156944,9,199113,0.414351327230592,194
27,"GCA","ACA","A","T",8,44343,26,155187,34,199530,0.550828227993547,195
27,"GCA","GAA","A","E",9,44343,10,155187,19,199530,0.0941958076899517,196
27,"GCA","GCA","A","A",44318,44343,155116,155187,199434,199530,1,197
27,"GCA","GCG","A","A",2,44343,6,155187,8,199530,0.367722796512193,198
27,"GCA","GTA","A","V",2,44343,14,155187,16,199530,1.11212168115684,199
27,"GCA","TCA","A","S",4,44343,15,155187,19,199530,0.607541893690307,200
28,"CCA","ACA","P","T",1,45261,1,152317,2,197578,0.0846076547257304,201
28,"CCA","CAA","P","Q",3,45261,6,152317,9,197578,0.239322457959468,202
28,"CCA","CCA","P","P",45249,45261,152286,152317,197535,197578,1,203
28,"CCA","CCC","P","P",0,45261,1,152317,1,197578,0.30244259049657,204
28,"CCA","CCG","P","P",1,45261,6,152317,7,197578,0.733113994741473,205
28,"CCA","CCT","P","P",1,45261,0,152317,1,197578,1.40812678910529,206
28,"CCA","CGA","P","R",0,45261,2,152317,2,197578,0.584787715536104,207
28,"CCA","CTA","P","L",4,45261,6,152317,10,197578,0.159605826343363,208
28,"CCA","GCA","P","A",0,45261,1,152317,1,197578,0.30244259049657,209
28,"CCA","TCA","P","S",2,45261,8,152317,10,197578,0.584787715536104,210
29,"GAG","GAA","E","E",0,46968,3,150195,3,197163,0.941866884470477,211
29,"GAG","GAG","E","E",46958,46968,150159,150195,197117,197163,1,212
29,"GAG","GAT","E","D",0,46968,11,150195,11,197163,2.71356070009775,213
29,"GAG","GCG","E","A",0,46968,2,150195,2,197163,0.63136770461524,214
29,"GAG","GGG","E","G",0,46968,5,150195,5,197163,1.50867158541337,215
29,"GAG","TAG","E",".",10,46968,15,150195,25,197163,0.188064272350405,216
30,"ACA","AAA","T","K",4,48385,8,147816,12,196201,0.29791935087632,217
30,"ACA","ACA","T","T",48371,48385,147797,147816,196168,196201,1,218
30,"ACA","ACC","T","T",1,48385,0,147816,1,196201,1.41272087650027,219
30,"ACA","ACG","T","T",1,48385,2,147816,3,196201,0.215924861846633,220
30,"ACA","AGA","T","R",2,48385,0,147816,2,196201,2.20905599461985,221
30,"ACA","ATA","T","I",3,48385,6,147816,9,196201,0.2837043235586,222
30,"ACA","GCA","T","A",3,48385,3,147816,6,196201,0.101757684594599,223
31,"CCA","ACA","P","T",6,50806,6,143199,12,194005,0.118545613644354,224
31,"CCA","CAA","P","Q",3,50806,6,143199,9,194005,0.326018371667338,225
31,"CCA","CCA","P","P",50790,50806,143167,143199,193957,194005,1,226
31,"CCA","CCC","P","P",0,50806,1,143199,1,194005,0.40775109971068,227
31,"CCA","CCG","P","P",3,50806,2,143199,5,194005,0.643765744356447,228
31,"CCA","CCT","P","P",1,50806,0,143199,1,194005,1.41727405328013,229
31,"CCA","CTA","P","L",2,50806,10,143199,12,194005,0.990319309585855,230
31,"CCA","GCA","P","A",0,50806,1,143199,1,194005,0.40775109971068,231
31,"CCA","TCA","P","S",1,50806,6,143199,7,194005,0.932858047261853,232
32,"CCA","ACA","P","T",4,54156,6,141261,10,195417,0.253111920229379,233
32,"CCA","CAA","P","Q",3,54156,7,141261,10,195417,0.462356383214366,234
32,"CCA","CCA","P","P",54141,54156,141235,141261,195376,195417,1,235
32,"CCA","CCC","P","P",0,54156,5,141261,5,195417,1.83900870782275,236
32,"CCA","CCG","P","P",3,54156,2,141261,5,195417,0.654785981673201,237
32,"CCA","CCT","P","P",0,54156,1,141261,1,195417,0.462356383214366,238
32,"CCA","CGA","P","R",0,54156,2,141261,2,195417,0.842676445713295,239
32,"CCA","CTA","P","L",0,54156,1,141261,1,195417,0.462356383214366,240
32,"CCA","GCA","P","A",2,54156,0,141261,2,195417,2.21342079299024,241
32,"CCA","TCA","P","S",3,54156,2,141261,5,195417,0.654785981673201,242
33,"CCG","ACG","P","T",1,57140,6,136312,7,193452,1.14836320835216,243
33,"CCG","CAG","P","Q",6,57140,8,136312,14,193452,0.255058953414382,244
33,"CCG","CCA","P","P",17,57140,53,136312,70,193452,0.948493169810597,245
33,"CCG","CCC","P","P",1,57140,2,136312,3,193452,0.333219876273127,246
33,"CCG","CCG","P","P",57092,57140,136183,136312,193275,193452,1,247
33,"CCG","CCT","P","P",13,57140,36,136312,49,193452,0.800929915303582,248
33,"CCG","CGG","P","R",0,57140,2,136312,2,193452,0.948493169810597,249
33,"CCG","CTG","P","L",6,57140,15,136312,21,193452,0.651409458632702,250
33,"CCG","TCG","P","S",4,57140,7,136312,11,193452,0.371521402435183,251
34,"CCC","ACC","P","T",3,58785,7,132287,10,191072,0.582037647643891,252
34,"CCC","CAA","P","Q",0,58785,1,132287,1,191072,0.582037647643891,253
34,"CCC","CAC","P","H",2,58785,3,132287,5,191072,0.300822510189566,254
34,"CCC","CCA","P","P",6,58785,4,132287,10,191072,0.768913232296877,255
34,"CCC","CCC","P","P",58767,58785,132264,132287,191031,191072,1,256
34,"CCC","CCT","P","P",2,58785,3,132287,5,191072,0.300822510189566,257
34,"CCC","CTC","P","L",4,58785,3,132287,7,191072,0.565268560596385,258
34,"CCC","TCC","P","S",1,58785,2,132287,3,191072,0.367552640817545,259
35,"GCC","ACC","A","T",15,61088,40,130115,55,191203,0.895281485725154,260
35,"GCC","GAC","A","D",3,61088,12,130115,15,191203,1.20274522111863,261
35,"GCC","GCA","A","A",2,61088,9,130115,11,191203,1.2384390680178,262
35,"GCC","GCC","A","A",61061,61088,130030,130115,191091,191203,1,263
35,"GCC","GCT","A","A",2,61088,8,130115,10,191203,1.09349293805838,264
35,"GCC","GGC","A","G",1,61088,0,130115,1,191203,1.43995837460755,265
35,"GCC","GTC","A","V",1,61088,7,130115,8,191203,1.51035147806404,266
35,"GCC","TCC","A","S",3,61088,9,130115,12,191203,0.866365271399466,267
36,"ATT","AAT","I","N",1,63151,0,123452,1,186603,1.44966467847962,268
36,"ATT","ACT","I","T",2,63151,1,123452,3,186603,0.920953938515588,269
36,"ATT","AGT","I","S",0,63151,4,123452,4,186603,2.02050477065117,270
36,"ATT","ATA","I","I",1,63151,1,123452,2,186603,0.232448319995107,271
36,"ATT","ATC","I","I",0,63151,2,123452,2,186603,1.21050159540354,272
36,"ATT","ATT","I","I",63147,63151,123443,123452,186590,186603,1,273
36,"ATT","GTT","I","V",0,63151,1,123452,1,186603,0.716248754020352,274
37,"GCG","ACG","A","T",4,65068,2,119498,6,184566,1.12306806493457,275
37,"GCG","CCG","A","P",2,65068,0,119498,2,184566,2.22963734378777,276
37,"GCG","GAG","A","E",5,65068,9,119498,14,184566,0.600809578869856,277
37,"GCG","GCA","A","A",5,65068,8,119498,13,184566,0.511092537767265,278
37,"GCG","GCG","A","A",65010,65068,119392,119498,184402,184566,1,279
37,"GCG","GCT","A","A",3,65068,6,119498,9,184566,0.646062379909357,280
37,"GCG","GTG","A","V",36,65068,67,119498,103,184566,0.693873149989195,281
37,"GCG","TCG","A","S",3,65068,14,119498,17,184566,1.64276579536788,282
38,"GAC","AAC","D","N",2,67702,1,118696,3,186398,0.946011467281496,283
38,"GAC","CAC","D","H",1,67702,0,118696,1,186398,1.46450855461793,284
38,"GAC","GAA","D","E",2,67702,3,118696,5,186398,0.456487149214193,285
38,"GAC","GAC","D","D",67685,67702,118652,118696,186337,186398,1,286
38,"GAC","GAT","D","D",5,67702,3,118696,8,186398,0.946011467281496,287
38,"GAC","GGC","D","G",1,67702,5,118696,6,186398,1.36832209945328,288
38,"GAC","TAC","D","Y",6,67702,32,118696,38,186398,2.10805658016881,289
39,"CTG","ATG","L","M",5,69387,3,115153,8,184540,0.960540654796345,290
39,"CTG","CAG","L","Q",0,69387,2,115153,2,184540,1.45114063165625,291
39,"CTG","CCG","L","P",12,69387,15,115153,27,184540,0.438277353451746,292
39,"CTG","CGG","L","R",0,69387,1,115153,1,184540,0.897081622898762,293
39,"CTG","CTA","L","L",34,69387,74,115153,108,184540,0.981080484110543,294
39,"CTG","CTC","L","L",1,69387,0,115153,1,184540,1.47318484946296,295
39,"CTG","CTG","L","L",69321,69387,115040,115153,184361,184540,1,296
39,"CTG","CTT","L","L",9,69387,17,115153,26,184540,0.777705573694468,297
39,"CTG","TTG","L","L",5,69387,1,115153,6,184540,2.23677738079293,298
40,"CTC","ATC","L","I",10,70250,5,111120,15,181370,1.32461101524374,299
40,"CTC","CCC","L","P",1,70250,6,111120,7,181370,1.77414455399131,300
40,"CTC","CGC","L","R",1,70250,0,111120,1,181370,1.48151614968262,301
40,"CTC","CTA","L","L",8,70250,19,111120,27,181370,1.08970208612985,302
40,"CTC","CTC","L","L",70218,70250,111079,111120,181297,181370,1,303
40,"CTC","CTG","L","L",1,70250,1,111120,2,181370,0.336194409262978,304
40,"CTC","CTT","L","L",4,70250,3,111120,7,181370,0.674020983253206,305
40,"CTC","TTC","L","F",7,70250,7,111120,14,181370,0.336194409262978,306
41,"AAA","AAA","K","K",71389,71390,107009,107012,178398,178402,1,307
41,"AAA","AAC","K","N",0,71390,2,107012,2,178402,1.61055906720337,308
41,"AAA","AAT","K","N",0,71390,1,107012,1,178402,1.02254827188389,309
41,"AAA","ACA","K","T",1,71390,0,107012,1,178402,1.49179508988468,310
42,"TCG","ACG","S","T",0,72751,3,104371,3,177122,2.17170838483325,311
42,"TCG","CCG","S","P",0,72751,1,104371,1,177122,1.07953644182667,312
42,"TCG","TAG","S",".",9,72751,13,104371,22,177122,0.668969373908116,313
42,"TCG","TCA","S","S",3,72751,12,104371,15,177122,1.81345014013785,314
42,"TCG","TCG","S","S",72715,72751,104324,104371,177039,177122,1,315
42,"TCG","TCT","S","S",13,72751,6,104371,19,177122,1.50092325197224,316
42,"TCG","TTG","S","L",11,72751,12,104371,23,177122,0.451186422973011,317
43,"GTA","ATA","V","I",9,73933,11,98707,20,172640,0.592223433838255,318
43,"GTA","GAA","V","E",0,73933,4,98707,4,172640,2.70990487681966,319
43,"GTA","GCA","V","A",0,73933,1,98707,1,172640,1.17694749386909,320
43,"GTA","GTA","V","V",73920,73933,98682,98707,172602,172640,1,321
43,"GTA","GTG","V","V",3,73933,4,98707,7,172640,0.629536427258789,322
43,"GTA","TTA","V","L",1,73933,5,98707,6,172640,1.80006232858628,323
44,"GAC","CAC","D","H",1,74989,0,93432,1,168421,1.53557537494076,324
44,"GAC","GAA","D","E",7,74989,2,93432,9,168421,2.04835171166829,325
44,"GAC","GAC","D","D",74968,74989,93419,93432,168387,168421,1,326
44,"GAC","GAT","D","D",5,74989,5,93432,10,168421,0.497130350630429,327
44,"GAC","GGC","D","G",2,74989,2,93432,4,168421,0.497130350630429,328
44,"GAC","TAC","D","Y",6,74989,4,93432,10,168421,0.957047495763871,329
45,"AGT","AAT","S","N",6,76113,2,87642,8,163755,1.82434173564182,330
45,"AGT","ACT","S","T",1,76113,0,87642,1,163755,1.55904291747711,331
45,"AGT","AGA","S","R",1,76113,4,87642,5,163755,1.74295084793402,332
45,"AGT","AGC","S","S",0,76113,4,87642,4,163755,2.9885425384347,333
45,"AGT","AGT","S","S",76101,76113,87625,87642,163726,163755,1,334
45,"AGT","ATT","S","I",2,76113,5,87642,7,163755,1.39055411482886,335
45,"AGT","GGT","S","G",2,76113,1,87642,3,163755,1.1000342236912,336
45,"AGT","TGT","S","C",0,76113,1,87642,1,163755,1.39055411482886,337
46,"GAG","AAG","E","K",2,76375,1,82711,3,159086,1.13223052985348,338
46,"GAG","CAG","E","Q",1,76375,0,82711,1,159086,1.57950828860171,339
46,"GAG","GAA","E","E",1,76375,0,82711,1,159086,1.57950828860171,340
46,"GAG","GAC","E","D",1,76375,0,82711,1,159086,1.57950828860171,341
46,"GAG","GAG","E","E",76345,76375,82683,82711,159028,159086,1,342
46,"GAG","GAT","E","D",3,76375,4,82711,7,159086,0.846786006832055,343
46,"GAG","GCG","E","A",0,76375,1,82711,1,159086,1.48393741850848,344
46,"GAG","GGG","E","G",10,76375,15,82711,25,159086,1.03096946532105,345
46,"GAG","GTG","E","V",2,76375,2,82711,4,159086,0.616573411335482,346
46,"GAG","TAG","E",".",10,76375,5,82711,15,159086,1.43833643971225,347
47,"GCT","ACT","A","T",6,76013,6,74620,12,150633,0.674813484745864,348
47,"GCT","CCT","A","P",1,76013,0,74620,1,150633,1.57994045923948,349
47,"GCT","GAT","A","D",15,76013,14,74620,29,150633,0.740239973015531,350
47,"GCT","GCC","A","A",2,76013,1,74620,3,150633,1.15317940014485,351
47,"GCT","GCG","A","A",3,76013,0,74620,3,150633,2.79841891975003,352
47,"GCT","GCT","A","A",75975,76013,74582,74620,150557,150633,1,353
47,"GCT","GTT","A","V",3,76013,8,74620,11,150633,1.7961111017959,354
47,"GCT","TCT","A","S",8,76013,9,74620,17,150633,0.787654578791797,355
48,"GTG","ATG","V","M",6,76354,8,71878,14,148232,0.931783096884016,356
48,"GTG","GAG","V","E",0,76354,2,71878,2,148232,2.29111670774864,357
48,"GTG","GCG","V","A",0,76354,2,71878,2,148232,2.29111670774864,358
48,"GTG","GGG","V","G",2,76354,0,71878,2,148232,2.19430268396545,359
48,"GTG","GTA","V","V",0,76354,1,71878,1,148232,1.58636809072533,360
48,"GTG","GTG","V","V",76336,76354,71852,71878,148188,148232,1,361
48,"GTG","GTT","V","V",4,76354,11,71878,15,148232,1.89401084553154,362
48,"GTG","TTG","V","L",6,76354,2,71878,8,148232,1.76192228559282,363
49,"AGG","AAG","R","K",1,77297,1,68867,2,146164,0.584341140956053,364
49,"AGG","AGA","R","R",1,77297,5,68867,6,146164,2.28175042369471,365
49,"AGG","AGG","R","R",77273,77297,68847,68867,146120,146164,1,366
49,"AGG","AGT","R","S",6,77297,3,68867,9,146164,1.23286319863863,367
49,"AGG","ATG","R","M",3,77297,5,68867,8,146164,1.11310960264682,368
49,"AGG","GAG","R","E",1,77297,0,68867,1,146164,1.4291706241289,369
49,"AGG","GGG","R","G",11,77297,6,68867,17,146164,1.20382048859329,370
49,"AGG","TGG","R","W",1,77297,0,68867,1,146164,1.4291706241289,371
50,"GAG","AAG","E","K",3,78351,2,68217,5,146568,0.853286247404355,372
50,"GAG","CAG","E","Q",2,78351,0,68217,2,146568,2.05680603666464,373
50,"GAG","GAA","E","E",4,78351,6,68217,10,146568,0.999853393042834,374
50,"GAG","GAG","E","E",78324,78351,68186,68217,146510,146568,1,375
50,"GAG","GAT","E","D",3,78351,4,68217,7,146568,0.841732404202533,376
50,"GAG","GGG","E","G",9,78351,8,68217,17,146568,0.660447549100222,377
50,"GAG","GTG","E","V",0,78351,1,68217,1,146568,1.5598028925896,378
50,"GAG","TAG","E",".",6,78351,10,68217,16,146568,1.17163691751932,379
51,"TAC","AAC","Y","N",0,77319,3,68148,3,145467,2.81999358586197,380
51,"TAC","TAA","Y",".",3,77319,4,68148,7,145467,0.849827399881052,381
51,"TAC","TAC","Y","Y",77306,77319,68132,68148,145438,145467,1,382
51,"TAC","TAG","Y",".",1,77319,0,68148,1,145467,1.41268607911914,383
51,"TAC","TAT","Y","Y",4,77319,8,68148,12,145467,1.39047139103349,384
51,"TAC","TCC","Y","S",0,77319,1,68148,1,145467,1.56375894678776,385
51,"TAC","TGC","Y","C",4,77319,0,68148,4,145467,3.01644510346191,386
51,"TAC","TTC","Y","F",1,77319,0,68148,1,145467,1.41268607911914,387
52,"TGC","AGC","C","S",1,77754,3,67531,4,145285,1.55902308145355,388
52,"TGC","CGC","C","R",6,77754,4,67531,10,145285,0.907525262196297,389
52,"TGC","CGG","C","R",0,77754,1,67531,1,145285,1.55902308145355,390
52,"TGC","TAC","C","Y",24,77754,23,67531,47,145285,0.597919456097941,391
52,"TGC","TGA","C",".",9,77754,7,67531,16,145285,0.778589611220275,392
52,"TGC","TGC","C","C",77708,77754,67484,67531,145192,145285,1,393
52,"TGC","TGT","C","C",1,77754,5,67531,6,145285,2.27769535076143,394
52,"TGC","TTC","C","F",5,77754,4,67531,9,145285,0.73525378786005,395
53,"AAA","AAA","K","K",78674,78676,65612,65615,144286,144291,1,396
53,"AAA","AAC","K","N",0,78676,1,65615,1,144291,1.54660772505164,397
53,"AAA","AAG","K","K",1,78676,0,65615,1,144291,1.33026847343034,398
53,"AAA","AGA","K","R",1,78676,1,65615,2,144291,0.527986328009839,399
53,"AAA","TAA","K",".",0,78676,1,65615,1,144291,1.54660772505164,400
54,"GAA","AAA","E","K",0,78852,1,63191,1,142043,1.53517211913459,401
54,"GAA","GAA","E","E",78842,78852,63178,63191,142020,142043,1,402
54,"GAA","GAC","E","D",0,78852,1,63191,1,142043,1.53517211913459,403
54,"GAA","GAG","E","E",0,78852,2,63191,2,142043,2.26614146397325,404
54,"GAA","TAA","E",".",10,78852,9,63191,19,142043,0.574910002139564,405
55,"AAA","AAA","K","K",79035,79075,59690,59721,138725,138796,1,406
55,"AAA","AAC","K","N",0,79075,1,59721,1,138796,1.51959736261229,407
55,"AAA","AAG","K","K",31,79075,29,59721,60,138796,0.500151421770601,408
55,"AAA","AAT","K","N",6,79075,1,59721,7,138796,2.07784170725694,409
55,"AAA","ATA","K","I",3,79075,0,59721,3,138796,2.31512156900996,410
56,"GGA","AGA","G","R",1,80084,1,58716,2,138800,0.430235928164741,411
56,"GGA","CGA","G","R",1,80084,0,58716,1,138800,1.14755513791887,412
56,"GGA","GAA","G","E",1,80084,0,58716,1,138800,1.14755513791887,413
56,"GGA","GGA","G","G",80063,80084,58704,58716,138767,138800,1,414
56,"GGA","GGG","G","G",2,80084,2,58716,4,138800,0.430235928164741,415
56,"GGA","GTA","G","V",8,80084,4,58716,12,138800,1.00864731983648,416
56,"GGA","TGA","G",".",8,80084,5,58716,13,138800,0.792832122365624,417
57,"TGG","AGG","W","R",1,81976,1,58010,2,139986,0.406034926222761,418
57,"TGG","TAG","W",".",2,81976,1,58010,3,139986,0.754676656006832,419
57,"TGG","TCG","W","S",1,81976,0,58010,1,139986,1.09975160038952,420
57,"TGG","TGA","W",".",2,81976,1,58010,3,139986,0.754676656006832,421
57,"TGG","TGG","W","W",81959,81976,58003,58010,139962,139986,1,422
57,"TGG","TGT","W","C",3,81976,2,58010,5,139986,0.636793121481289,423
57,"TGG","TTG","W","L",8,81976,2,58010,10,139986,1.70614615751484,424
58,"TTG","TGG","L","W",0,82238,2,57990,2,140228,2.25099744231135,425
58,"TTG","TTA","L","L",1,82238,3,57990,4,140228,1.5034558762774,426
58,"TTG","TTG","L","L",82231,82238,57983,57990,140214,140228,1,427
58,"TTG","TTT","L","F",6,82238,2,57990,8,140228,1.31022284352236,428
59,"GTT","ATT","V","I",9,83540,1,57647,10,141187,2.5577408639225,429
59,"GTT","CTT","V","L",1,83540,0,57647,1,141187,1.06645412836617,430
59,"GTT","GCT","V","A",0,83540,1,57647,1,141187,1.49878900701044,431
59,"GTT","GGT","V","G",1,83540,1,57647,2,141187,0.389515290796724,432
59,"GTT","GTT","V","V",83528,83540,57644,57647,141172,141187,1,433
59,"GTT","TTT","V","F",1,83540,0,57647,1,141187,1.06645412836617,434
60,"CCT","ACT","P","T",9,82874,7,59185,16,142059,0.5860358830722,435
60,"CCT","CAT","P","H",4,82874,3,59185,7,142059,0.5860358830722,436
60,"CCT","CCA","P","P",1,82874,0,59185,1,142059,1.1118375992705,437
60,"CCT","CCC","P","P",12,82874,8,59185,20,142059,0.724666435474848,438
60,"CCT","CCG","P","P",1,82874,0,59185,1,142059,1.1118375992705,439
60,"CCT","CCT","P","P",82845,82874,59162,59185,142007,142059,1,440
60,"CCT","CTT","P","L",0,82874,1,59185,1,142059,1.50629379738446,441
60,"CCT","TCT","P","S",2,82874,4,59185,6,142059,1.19020728531088,442
61,"GAG","AAG","E","K",3,82790,3,60107,6,142897,0.423492280094097,443
61,"GAG","GAA","E","E",2,82790,0,60107,2,142897,1.74842976196776,444
61,"GAG","GAC","E","D",1,82790,0,60107,1,142897,1.13434740007837,445
61,"GAG","GAG","E","E",82758,82790,60094,60107,142852,142897,1,446
61,"GAG","GAT","E","D",9,82790,4,60107,13,142897,1.13434740007837,447
61,"GAG","GGG","E","G",3,82790,2,60107,5,142897,0.661345458021976,448
61,"GAG","TAG","E",".",14,82790,4,60107,18,142897,1.74842976196776,449
62,"ATC","ACC","I","T",1,82948,0,62355,1,145303,1.18192572555069,450
62,"ATC","ATA","I","I",9,82948,5,62355,14,145303,0.943864629305656,451
62,"ATC","ATC","I","I",82935,82948,62348,62355,145283,145303,1,452
62,"ATC","ATG","I","M",2,82948,0,62355,2,145303,1.80606603442973,453
62,"ATC","ATT","I","I",1,82948,2,62355,3,145303,1.03501974418554,454
63,"AAC","AAA","N","K",4,82424,4,62900,8,145324,0.458879994304803,455
63,"AAC","AAC","N","N",82413,82424,62888,62900,145301,145324,1,456
63,"AAC","AAG","N","K",1,82424,1,62900,2,145324,0.458879994304803,457
63,"AAC","AAT","N","N",1,82424,3,62900,4,145324,1.52220123143565,458
63,"AAC","ACC","N","T",1,82424,0,62900,1,145324,1.20273300362676,459
63,"AAC","AGC","N","S",1,82424,2,62900,3,145324,1.04108938709769,460
63,"AAC","GAC","N","D",3,82424,2,62900,5,145324,0.710594798461253,461
64,"TCC","ACC","S","T",1,83621,0,63985,1,147606,1.20651993036365,462
64,"TCC","CCC","S","P",3,83621,6,63985,9,147606,1.29416773550657,463
64,"TCC","TAC","S","Y",9,83621,10,63985,19,147606,0.585260501242843,464
64,"TCC","TCA","S","S",7,83621,0,63985,7,147606,3.64986190382568,465
64,"TCC","TCC","S","S",83598,83621,63965,63985,147563,147606,1,466
64,"TCC","TCT","S","S",2,83621,3,63985,5,147606,0.86003204470671,467
64,"TCC","TGC","S","C",0,83621,1,63985,1,147606,1.5228901320977,468
64,"TCC","TTC","S","F",1,83621,0,63985,1,147606,1.20651993036365,469
65,"ACC","AAC","T","N",3,85415,2,64499,5,149914,0.699864774547183,470
65,"ACC","ACA","T","T",2,85415,9,64499,11,149914,2.45798018490742,471
65,"ACC","ACC","T","T",85396,85415,64477,64499,149873,149914,1,472
65,"ACC","ACG","T","T",0,85415,1,64499,1,149914,1.51953130837102,473
65,"ACC","ACT","T","T",3,85415,3,64499,6,149914,0.451128314521812,474
65,"ACC","AGC","T","S",1,85415,0,64499,1,149914,1.18794431192058,475
65,"ACC","ATC","T","I",7,85415,4,64499,11,149914,0.899922214839034,476
65,"ACC","GCC","T","A",3,85415,3,64499,6,149914,0.451128314521812,477
66,"CTC","ATC","L","I",7,84461,8,66141,15,150602,0.630690598279996,478
66,"CTC","CAC","L","H",1,84461,1,66141,2,150602,0.478271048351816,479
66,"CTC","CCC","L","P",17,84461,9,66141,26,150602,1.09428157587145,480
66,"CTC","CTA","L","L",6,84461,3,66141,9,150602,1.05715755028992,481
66,"CTC","CTC","L","L",84425,84461,66115,66141,150540,150602,1,482
66,"CTC","CTG","L","L",1,84461,0,66141,1,150602,1.23928129981558,483
66,"CTC","CTT","L","L",2,84461,4,66141,6,150602,1.22114269829038,484
66,"CTC","TTC","L","F",2,84461,1,66141,3,150602,0.867052620540026,485
67,"CAA","AAA","Q","K",6,85261,3,67895,9,153156,1.07917310489142,486
67,"CAA","CAA","Q","Q",85251,85261,67891,67895,153142,153156,1,487
67,"CAA","CGA","Q","R",2,85261,0,67895,2,153156,1.90327458426204,488
67,"CAA","TAA","Q",".",2,85261,1,67895,3,153156,0.886637781982857,489
68,"ATT","AAT","I","N",0,86028,1,68195,1,154223,1.53219908279311,490
68,"ATT","ACT","I","T",1,86028,1,68195,2,154223,0.487563394152893,491
68,"ATT","ATC","I","I",1,86028,2,68195,3,154223,1.05721504203675,492
68,"ATT","ATT","I","I",86026,86028,68191,68195,154217,154223,1,493
69,"GAG","AAG","E","K",1,87138,1,68925,2,156063,0.485897849735797,494
69,"GAG","GAA","E","E",1,87138,2,68925,3,156063,1.05627314691534,495
69,"GAG","GAC","E","D",1,87138,0,68925,1,156063,1.25348719622971,496
69,"GAG","GAG","E","E",87111,87138,68902,68925,156013,156063,1,497
69,"GAG","GAT","E","D",5,87138,7,68925,12,156063,0.87688927232119,498
69,"GAG","GGG","E","G",10,87138,7,68925,17,156063,0.780626390302634,499
69,"GAG","GTG","E","V",3,87138,1,68925,4,156063,1.25348719622971,500
69,"GAG","TAG","E",".",6,87138,5,68925,11,156063,0.616027064435834,501
70,"AAA","AAA","K","K",87420,87421,69237,69244,156657,156665,1,502
70,"AAA","AAG","K","K",1,87421,2,69244,3,156665,1.05684341953028,503
70,"AAA","ACA","K","T",0,87421,1,69244,1,156665,1.53196798885878,504
70,"AAA","AGA","K","R",0,87421,2,69244,2,156665,2.26460014231443,505
70,"AAA","GAA","K","E",0,87421,1,69244,1,156665,1.53196798885878,506
70,"AAA","TAA","K",".",0,87421,1,69244,1,156665,1.53196798885878,507
71,"CAT","AAT","H","N",4,87885,5,69668,9,157553,0.726803082836474,508
71,"CAT","CAC","H","H",4,87885,1,69668,5,157553,1.59490448637593,509
71,"CAT","CAG","H","Q",2,87885,0,69668,2,157553,1.89553613962303,510
71,"CAT","CAT","H","H",87870,87885,69659,69668,157529,157553,1,511
71,"CAT","CCT","H","P",0,87885,1,69668,1,157553,1.53222362457103,512
71,"CAT","CGT","H","R",3,87885,1,69668,4,157553,1.25670642799904,513
71,"CAT","TAT","H","Y",2,87885,1,69668,3,157553,0.881297141629706,514
72,"GTC","ATC","V","I",3,87404,0,70335,3,157739,2.43008174001282,515
72,"GTC","GCC","V","A",1,87404,0,70335,1,157739,1.27813901251878,516
72,"GTC","GTA","V","V",5,87404,9,70335,14,157739,1.23117911537065,517
72,"GTC","GTC","V","V",87388,87404,70318,70335,157706,157739,1,518
72,"GTC","GTG","V","V",0,87404,1,70335,1,157739,1.53632689344933,519
72,"GTC","GTT","V","V",3,87404,3,70335,6,157739,0.499251801978577,520
72,"GTC","TTC","V","F",4,87404,4,70335,8,157739,0.499251801978577,521
73,"AGT","AAT","S","N",2,88470,3,70524,5,158994,0.880972697655924,522
73,"AGT","AGA","S","R",0,88470,1,70524,1,158994,1.53373719629663,523
73,"AGT","AGC","S","S",6,88470,1,70524,7,158994,2.17298707323042,524
73,"AGT","AGT","S","S",88459,88470,70516,70524,158975,158994,1,525
73,"AGT","ATT","S","I",2,88470,2,70524,4,158994,0.491929091210863,526
73,"AGT","GGT","S","G",1,88470,1,70524,2,158994,0.491929091210863,527
74,"CGG","AGG","R","R",14,88879,10,70950,24,159829,0.78173699838017,528
74,"CGG","CAG","R","Q",7,88879,3,70950,10,159829,1.26684512525829,529
74,"CGG","CGA","R","R",3,88879,1,70950,4,159829,1.26684512525829,530
74,"CGG","CGC","R","R",0,88879,2,70950,2,159829,2.26565230229309,531
74,"CGG","CGG","R","R",88834,88879,70923,70950,159757,159829,1,532
74,"CGG","CGT","R","R",6,88879,4,70950,10,159829,0.810628725552236,533
74,"CGG","CTG","R","L",10,88879,4,70950,14,159829,1.40733637381589,534
74,"CGG","GGG","R","G",1,88879,0,70950,1,159829,1.26684512525829,535
74,"CGG","TGG","R","W",4,88879,3,70950,7,159829,0.691120953547567,536
75,"GCT","ACT","A","T",22,88307,11,71963,33,160270,1.23540228559012,537
75,"GCT","GAT","A","D",28,88307,23,71963,51,160270,0.677870365928639,538
75,"GCT","GCC","A","A",3,88307,2,71963,5,160270,0.779636195056532,539
75,"GCT","GCG","A","A",0,88307,1,71963,1,160270,1.53990171053573,540
75,"GCT","GCT","A","A",88242,88307,71912,71963,160154,160270,1,541
75,"GCT","GTT","A","V",2,88307,4,71963,6,160270,1.23602643109293,542
75,"GCT","TCT","A","S",10,88307,10,71963,20,160270,0.50930355406969,543
76,"TTC","ATC","F","I",2,88050,1,72275,3,160325,0.922717725254261,544
76,"TTC","CTC","F","L",2,88050,1,72275,3,160325,0.922717725254261,545
76,"TTC","GTC","F","V",0,88050,1,72275,1,160325,1.54197902826749,546
76,"TTC","TAC","F","Y",1,88050,0,72275,1,160325,1.30706798503185,547
76,"TTC","TCC","F","S",0,88050,5,72275,5,160325,3.6020634426095,548
76,"TTC","TTA","F","L",10,88050,5,72275,15,160325,1.18320465551652,549
76,"TTC","TTC","F","F",88031,88050,72262,72275,160293,160325,1,550
76,"TTC","TTT","F","F",4,88050,0,72275,4,160325,2.88176645993128,551
77,"ATT","AAT","I","N",1,89219,2,72415,3,161634,1.06770893707158,552
77,"ATT","ACT","I","T",3,89219,1,72415,4,161634,1.29056270287836,553
77,"ATT","ATT","I","I",89212,89219,72405,72415,161617,161634,1,554
77,"ATT","GTT","I","V",2,89219,7,72415,9,161634,2.05024686149831,555
77,"ATT","TTT","I","F",1,89219,0,72415,1,161634,1.29056270287836,556
78,"TGC","CGC","C","R",2,90679,0,73733,2,164412,1.93895228640169,557
78,"TGC","TAC","C","Y",7,90679,1,73733,8,164412,2.44931232681268,558
78,"TGC","TGA","C",".",6,90679,3,73733,9,164412,1.10696099042103,559
78,"TGC","TGC","C","C",90646,90679,73712,73733,164358,164412,1,560
78,"TGC","TGG","C","W",1,90679,0,73733,1,164412,1.29338245999694,561
78,"TGC","TGT","C","C",1,90679,4,73733,5,164412,1.93315395927996,562
78,"TGC","TTC","C","F",16,90679,13,73733,29,164412,0.680589380097367,563
79,"TTA","ATA","L","I",0,90911,1,73811,1,164722,1.53884525122023,564
79,"TTA","CTA","L","L",1,90911,0,73811,1,164722,1.29111181800966,565
79,"TTA","GTA","L","V",0,90911,1,73811,1,164722,1.53884525122023,566
79,"TTA","TCA","L","S",1,90911,2,73811,3,164722,1.06788051821831,567
79,"TTA","TTA","L","L",90905,90911,73807,73811,164712,164722,1,568
79,"TTA","TTG","L","L",2,90911,0,73811,2,164722,1.93627279410263,569
79,"TTA","TTT","L","F",2,90911,0,73811,2,164722,1.93627279410263,570
80,"CAG","AAG","Q","K",5,90694,3,74940,8,165634,0.930697210958671,571
80,"CAG","CAA","Q","Q",1,90694,6,74940,7,165634,2.55976592550907,572
80,"CAG","CAG","Q","Q",90661,90694,74914,74940,165575,165634,1,573
80,"CAG","CAT","Q","H",8,90694,4,74940,12,165634,1.16696811123882,574
80,"CAG","CCG","Q","P",1,90694,1,74940,2,165634,0.520452966847311,575
80,"CAG","CGG","Q","R",7,90694,4,74940,11,165634,1.01085215729181,576
80,"CAG","CTG","Q","L",2,90694,2,74940,4,165634,0.520452966847311,577
80,"CAG","TAG","Q",".",9,90694,6,74940,15,165634,0.872735178943006,578
81,"GCA","ACA","A","T",48,90679,32,76293,80,166972,0.940497117251939,579
81,"GCA","CCA","A","P",1,90679,0,76293,1,166972,1.34351640037878,580
81,"GCA","GAA","A","E",21,90679,17,76293,38,166972,0.721644752399967,581
81,"GCA","GCA","A","A",90599,90679,76239,76293,166838,166972,1,582
81,"GCA","GGA","A","G",2,90679,0,76293,2,166972,1.99784054332681,583
81,"GCA","GTA","A","V",5,90679,4,76293,9,166972,0.702948349283373,584
81,"GCA","TCA","A","S",3,90679,1,76293,4,166972,1.34351640037878,585
82,"TTG","ATG","L","M",1,89849,0,76636,1,166485,1.36349708854107,586
82,"TTG","CTG","L","L",1,89849,1,76636,2,166485,0.546652481470645,587
82,"TTG","TAG","L",".",0,89849,1,76636,1,166485,1.55338819190389,588
82,"TTG","TCG","L","S",0,89849,1,76636,1,166485,1.55338819190389,589
82,"TTG","TTA","L","L",0,89849,3,76636,3,166485,2.81705171757012,590
82,"TTG","TTG","L","L",89837,89849,76623,76636,166460,166485,1,591
82,"TTG","TTT","L","F",10,89849,7,76636,17,166485,0.865147000202396,592
83,"ACC","AAC","T","N",5,90370,1,76909,6,167279,2.01770469553711,593
83,"ACC","ACA","T","T",8,90370,4,76909,12,167279,1.20823624166395,594
83,"ACC","ACC","T","T",90335,90370,76894,76909,167229,167279,1,595
83,"ACC","ACT","T","T",6,90370,2,76909,8,167279,1.59834215997164,596
83,"ACC","AGC","T","S",2,90370,1,76909,3,167279,0.967082893105214,597
83,"ACC","ATC","T","I",5,90370,5,76909,10,167279,0.544972075961101,598
83,"ACC","GCC","T","A",9,90370,2,76909,11,167279,2.20283869606766,599
84,"ACA","AAA","T","K",6,91262,4,76357,10,167619,0.863772713218306,600
84,"ACA","ACA","T","T",91254,91262,76351,76357,167605,167619,1,601
84,"ACA","ATA","T","I",2,91262,1,76357,3,167619,0.945891020422427,602
84,"ACA","GCA","T","A",0,91262,1,76357,1,167619,1.54757261074118,603
85,"TTT","GTT","F","V",2,89417,0,75481,2,164898,2.00329580819452,604
85,"TTT","TAT","F","Y",1,89417,0,75481,1,164898,1.34818271643355,605
85,"TTT","TCT","F","S",1,89417,1,75481,2,164898,0.538015874721608,606
85,"TTT","TTC","F","F",2,89417,3,75481,5,164898,0.912436611438201,607
85,"TTT","TTT","F","F",89411,89417,75477,75481,164888,164898,1,608
86,"GTG","ATG","V","M",3,90725,1,73907,4,164632,1.29593687349205,609
86,"GTG","CTG","V","L",0,90725,1,73907,1,164632,1.53978865226519,610
86,"GTG","GTA","V","V",1,90725,1,73907,2,164632,0.50898664863037,611
86,"GTG","GTG","V","V",90715,90725,73898,73907,164613,164632,1,612
86,"GTG","GTT","V","V",3,90725,4,73907,7,164632,0.800253207982685,613
86,"GTG","TTG","V","L",3,90725,2,73907,5,164632,0.779206235367341,614
87,"TCA","CCA","S","P",6,90807,3,73726,9,164533,1.10495132929583,615
87,"TCA","TAA","S",".",10,90807,5,73726,15,164533,1.1681225020829,616
87,"TCA","TCA","S","S",90781,90807,73711,73726,164492,164533,1,617
87,"TCA","TCG","S","S",4,90807,4,73726,8,164533,0.506390173852013,618
87,"TCA","TGA","S",".",0,90807,2,73726,2,164533,2.26792021077414,619
87,"TCA","TTA","S","L",6,90807,1,73726,7,164533,2.20566773319227,620
88,"GTG","ATG","V","M",4,90580,6,73528,10,164108,0.962737208570696,621
88,"GTG","CTG","V","L",1,90580,0,73528,1,164108,1.29072467420922,622
88,"GTG","GAG","V","E",1,90580,0,73528,1,164108,1.29072467420922,623
88,"GTG","GCG","V","A",0,90580,2,73528,2,164108,2.26787511367857,624
88,"GTG","GTG","V","V",90572,90580,73517,73528,164089,164108,1,625
88,"GTG","GTT","V","V",2,90580,2,73528,4,164108,0.506127619896079,626
88,"GTG","TTG","V","L",0,90580,1,73528,1,164108,1.53876971497508,627
89,"GCT","ACT","A","T",19,88475,25,73855,44,162330,0.86981759991065,628
89,"GCT","GAT","A","D",8,88475,1,73855,9,162330,2.71493506524715,629
89,"GCT","GCA","A","A",2,88475,2,73855,4,162330,0.528552875709763,630
89,"GCT","GCC","A","A",10,88475,19,73855,29,162330,1.38685936258696,631
89,"GCT","GCG","A","A",1,88475,1,73855,2,162330,0.528552875709763,632
89,"GCT","GCT","A","A",88413,88475,73785,73855,162198,162330,1,633
89,"GCT","GGT","A","G",1,88475,1,73855,2,162330,0.528552875709763,634
89,"GCT","GTT","A","V",12,88475,12,73855,24,162330,0.528552875709763,635
89,"GCT","TCT","A","S",9,88475,9,73855,18,162330,0.528552875709763,636
90,"GGA","AGA","G","R",10,87810,8,74434,18,162244,0.72916232555352,637
90,"GGA","CGA","G","R",1,87810,1,74434,2,162244,0.541462832881335,638
90,"GGA","GAA","G","E",3,87810,3,74434,6,162244,0.541462832881335,639
90,"GGA","GCA","G","A",1,87810,0,74434,1,162244,1.35430711086241,640
90,"GGA","GGA","G","G",87780,87810,74407,74434,162187,162244,1,641
90,"GGA","GGG","G","G",1,87810,0,74434,1,162244,1.35430711086241,642
90,"GGA","GTA","G","V",8,87810,11,74434,19,162244,0.914808316897919,643
90,"GGA","TGA","G",".",6,87810,4,74434,10,162244,0.878919901696222,644
91,"ATC","ACC","I","T",0,86529,1,76258,1,162787,1.56373942557209,645
91,"ATC","ATA","I","I",8,86529,7,76258,15,162787,0.684584335844169,646
91,"ATC","ATC","I","I",86520,86529,76248,76258,162768,162787,1,647
91,"ATC","ATT","I","I",1,86529,1,76258,2,162787,0.574729465333888,648
91,"ATC","TTC","I","F",0,86529,1,76258,1,162787,1.56373942557209,649
92,"ATA","AAA","I","K",0,86920,1,76892,1,163812,1.56497957798104,650
92,"ATA","ACA","I","T",10,86920,10,76892,20,163812,0.578060218798516,651
92,"ATA","ATA","I","I",86905,86920,76879,76892,163784,163812,1,652
92,"ATA","ATG","I","M",2,86920,1,76892,3,163812,1.01552007490906,653
92,"ATA","GTA","I","V",3,86920,1,76892,4,163812,1.41835223711681,654
93,"TAT","AAT","Y","N",0,85658,2,77948,2,163606,2.28523961964812,655
93,"TAT","CAT","Y","H",1,85658,0,77948,1,163606,1.4614398046845,656
93,"TAT","TAT","Y","Y",85657,85658,77945,77948,163602,163606,1,657
93,"TAT","TTT","Y","F",0,85658,1,77948,1,163606,1.57444078157528,658
94,"ATA","ACA","I","T",1,87371,0,78202,1,165573,1.43607885509947,659
94,"ATA","ATA","I","I",87370,87371,78197,78202,165567,165573,1,660
94,"ATA","ATG","I","M",0,87371,4,78202,4,165573,3.25041497814427,661
94,"ATA","CTA","I","L",0,87371,1,78202,1,165573,1.5688335120585,662
95,"ATA","AAA","I","K",1,86928,0,78717,1,165645,1.45403031729393,663
95,"ATA","ACA","I","T",3,86928,0,78717,3,165645,2.64768596414434,664
95,"ATA","ATA","I","I",86923,86928,78716,78717,165639,165645,1,665
95,"ATA","GTA","I","V",1,86928,0,78717,1,165645,1.45403031729393,666
95,"ATA","TTA","I","L",0,86928,1,78717,1,165645,1.57279109024651,667
96,"TAT","CAT","Y","H",1,85956,0,76317,1,162273,1.42394521071345,668
96,"TAT","GAT","Y","D",0,85956,1,76317,1,162273,1.56618977361126,669
96,"TAT","TAA","Y",".",0,85956,1,76317,1,162273,1.56618977361126,670
96,"TAT","TAT","Y","Y",85950,85956,76315,76317,162265,162273,1,671
96,"TAT","TGT","Y","C",2,85956,0,76317,2,162273,2.09128582104492,672
96,"TAT","TTT","Y","F",3,85956,0,76317,3,162273,2.61109118006924,673
97,"AAG","AAA","K","K",1,85304,0,77227,1,162531,1.45370651155931,674
97,"AAG","AAG","K","K",85278,85304,77210,77227,162488,162531,1,675
97,"AAG","AAT","K","N",14,85304,8,77227,22,162531,1.18694216917374,676
97,"AAG","ACG","K","T",0,85304,2,77227,2,162531,2.28439426656867,677
97,"AAG","AGG","K","R",3,85304,2,77227,5,162531,0.899066824960931,678
97,"AAG","ATG","K","M",1,85304,3,77227,4,162531,1.57271921279134,679
97,"AAG","GAG","K","E",3,85304,1,77227,4,162531,1.45370651155931,680
97,"AAG","TAG","K",".",4,85304,1,77227,5,162531,1.81210961777523,681
98,"CTC","ATC","L","I",15,84947,7,77769,22,162716,1.47087505894154,682
98,"CTC","CTA","L","L",1,84947,1,77769,2,162716,0.608819831589615,683
98,"CTC","CTC","L","L",84929,84947,77758,77769,162687,162716,1,684
98,"CTC","CTT","L","L",1,84947,0,77769,1,162716,1.47087505894154,685
98,"CTC","TTC","L","F",1,84947,3,77769,4,162716,1.57655528856892,686
99,"TTT","ATT","F","I",0,84477,1,77350,1,161827,1.57657619740267,687
99,"TTT","TGT","F","C",1,84477,1,77350,2,161827,0.608874862230282,688
99,"TTT","TTC","F","F",1,84477,1,77350,2,161827,0.608874862230282,689
99,"TTT","TTT","F","F",84475,84477,77347,77350,161822,161827,1,690
100,"GCG","ACG","A","T",2,85011,1,78197,3,163208,1.0660818369887,691
100,"GCG","GAG","A","E",5,85011,10,78197,15,163208,1.43682680738667,692
100,"GCG","GCA","A","A",8,85011,3,78197,11,163208,1.66467440923581,693
100,"GCG","GCG","A","A",84941,85011,78137,78197,163078,163208,1,694
100,"GCG","GCT","A","A",6,85011,3,78197,9,163208,1.27857742110787,695
100,"GCG","GGG","A","G",2,85011,0,78197,2,163208,2.15361115202182,696
100,"GCG","GTG","A","V",37,85011,35,78197,72,163208,0.66415507693932,697
100,"GCG","TCG","A","S",10,85011,8,78197,18,163208,0.8171754482945,698
101,"GGT","AGT","G","S",3,87369,3,78865,6,166234,0.595979946428313,699
101,"GGT","GAT","G","D",1,87369,5,78865,6,166234,2.28389231546122,700
101,"GGT","GCT","G","A",2,87369,0,78865,2,166234,2.12025670425981,701
101,"GGT","GGC","G","G",2,87369,0,78865,2,166234,2.12025670425981,702
101,"GGT","GGG","G","G",2,87369,1,78865,3,166234,1.0414488513472,703
101,"GGT","GGT","G","G",87349,87369,78847,78865,166196,166234,1,704
101,"GGT","GTT","G","V",5,87369,4,78865,9,166234,0.77625789590158,705
101,"GGT","TGT","G","C",5,87369,5,78865,10,166234,0.595979946428313,706
102,"TTT","ATT","F","I",1,88122,0,79331,1,167453,1.44482727152902,707
102,"TTT","GGG","F","G",0,88122,1,79331,1,167453,1.57075526940305,708
102,"TTT","GGT","F","G",0,88122,2,79331,2,167453,2.28343080317693,709
102,"TTT","GTT","F","V",0,88122,5,79331,5,167453,3.60577715071342,710
102,"TTT","TCT","F","S",2,88122,2,79331,4,167453,0.593481462807274,711
102,"TTT","TTA","F","L",0,88122,2,79331,2,167453,2.28343080317693,712
102,"TTT","TTC","F","F",3,88122,1,79331,4,167453,1.44482727152902,713
102,"TTT","TTT","F","F",88116,88122,79318,79331,167434,167453,1,714
103,"CAA","AAA","Q","K",7,87121,6,79033,13,166154,0.729948879795122,715
103,"CAA","CAA","Q","Q",87076,87121,78996,79033,166072,166154,1,716
103,"CAA","CAC","Q","H",1,87121,6,79033,7,166154,2.57055112865997,717
103,"CAA","CAG","Q","Q",11,87121,7,79033,18,166154,1.04795444001387,718
103,"CAA","CAT","Q","H",9,87121,2,79033,11,166154,2.3169561944151,719
103,"CAA","CGA","Q","R",16,87121,13,79033,29,166154,0.794595514015737,720
103,"CAA","GAA","Q","E",1,87121,1,79033,2,166154,0.600498512555651,721
103,"CAA","TAA","Q",".",0,87121,2,79033,2,166154,2.28472936161135,722
104,"GGT","AGT","G","S",1,86896,2,80460,3,167356,1.13371866225338,723
104,"GGT","CGT","G","R",0,86896,1,80460,1,167356,1.58046000557474,724
104,"GGT","GAT","G","D",4,86896,2,80460,6,167356,1.21819586839744,725
104,"GGT","GGT","G","G",86885,86896,80442,80460,167327,167356,1,726
104,"GGT","GTT","G","V",0,86896,2,80460,2,167356,2.28820110077777,727
104,"GGT","TGT","G","C",6,86896,11,80460,17,167356,1.33393869786183,728
105,"GCT","ACT","A","T",3,86479,1,81107,4,167586,1.50816442522809,729
105,"GCT","GAT","A","D",5,86479,7,81107,12,167586,0.977342591724536,730
105,"GCT","GCA","A","A",1,86479,2,81107,3,167586,1.14090753844196,731
105,"GCT","GCC","A","A",4,86479,9,81107,13,167586,1.58506474853515,732
105,"GCT","GCG","A","A",2,86479,2,81107,4,167586,0.631062880402271,733
105,"GCT","GCT","A","A",86436,86479,81066,81107,167502,167586,1,734
105,"GCT","GTT","A","V",18,86479,11,81107,29,167586,1.16475161327719,735
105,"GCT","TCT","A","S",10,86479,9,81107,19,167586,0.72480322477428,736
106,"TAT","TAA","Y",".",0,85280,2,81354,2,166634,2.29354890600004,737
106,"TAT","TAC","Y","Y",1,85280,0,81354,1,166634,1.53475330211389,738
106,"TAT","TAT","Y","Y",85278,85280,81352,81354,166630,166634,1,739
106,"TAT","TGT","Y","C",1,85280,0,81354,1,166634,1.53475330211389,740
107,"ACA","AAA","T","K",5,87632,2,81859,7,169491,1.50228827096694,741
107,"ACA","ACA","T","T",87585,87632,81834,81859,169419,169491,1,742
107,"ACA","ACC","T","T",1,87632,1,81859,2,169491,0.627535568099084,743
107,"ACA","ACG","T","T",17,87632,10,81859,27,169491,1.20524912998415,744
107,"ACA","ACT","T","T",8,87632,4,81859,12,169491,1.34246902428643,745
107,"ACA","AGA","T","R",0,87632,1,81859,1,169491,1.58370751328167,746
107,"ACA","ATA","T","I",11,87632,6,81859,17,169491,1.2713095666093,747
107,"ACA","GCA","T","A",3,87632,1,81859,4,169491,1.50228827096694,748
107,"ACA","TCA","T","S",2,87632,0,81859,2,169491,2.18119696263496,749
108,"GGA","AGA","G","R",4,86482,5,83986,9,170468,0.868410339009742,750
108,"GGA","CGA","G","R",0,86482,1,83986,1,170468,1.59799660735734,751
108,"GGA","GAA","G","E",1,86482,2,83986,3,170468,1.16099833512577,752
108,"GGA","GCA","G","A",0,86482,2,83986,2,170468,2.29688080329915,753
108,"GGA","GGA","G","G",86461,86482,83966,83986,170427,170468,1,754
108,"GGA","GGG","G","G",1,86482,0,83986,1,170468,1.56286565742969,755
108,"GGA","GGT","G","G",0,86482,1,83986,1,170468,1.59799660735734,756
108,"GGA","GTA","G","V",10,86482,7,83986,17,170468,1.02356012648908,757
108,"GGA","TGA","G",".",5,86482,2,83986,7,170468,1.56286565742969,758
109,"GTG","ATG","V","M",1,85927,2,84314,3,170241,1.16720492824047,759
109,"GTG","CTG","V","L",0,85927,2,84314,2,170241,2.29887818207818,760
109,"GTG","GTA","V","V",9,85927,6,84314,15,170241,1.086979936586,761
109,"GTG","GTG","V","V",85891,85927,84287,84314,170178,170241,1,762
109,"GTG","GTT","V","V",24,85927,13,84314,37,170241,1.40383690205439,763
109,"GTG","TTG","V","L",2,85927,4,84314,6,170241,1.31929342131503,764
110,"CCC","ACC","P","T",7,85666,8,84869,15,170535,0.809604844864856,765
110,"CCC","CAC","P","H",4,85666,11,84869,15,170535,1.90826686045102,766
110,"CCC","CCA","P","P",3,85666,2,84869,5,170535,1.00967251761615,767
110,"CCC","CCC","P","P",85595,85666,84795,84869,170390,170535,1,768
110,"CCC","CCG","P","P",2,85666,0,84869,2,170535,2.28569871810773,769
110,"CCC","CCT","P","P",2,85666,4,84869,6,170535,1.32419889796432,770
110,"CCC","CGC","P","R",0,85666,1,84869,1,170535,1.60570995016409,771
110,"CCC","CTC","P","L",0,85666,1,84869,1,170535,1.60570995016409,772
110,"CCC","GCC","P","A",1,85666,0,84869,1,170535,1.59444194467267,773
110,"CCC","TCC","P","S",52,85666,47,84869,99,170535,0.786865628117867,774
111,"AAC","AAA","N","K",2,87119,2,84937,4,172056,0.668067208396429,775
111,"AAC","AAC","N","N",87111,87119,84926,84937,172037,172056,1,776
111,"AAC","AAG","N","K",0,87119,2,84937,2,172056,2.29761916666756,777
111,"AAC","AAT","N","N",4,87119,6,84937,10,172056,1.06831246195467,778
111,"AAC","ATC","N","I",1,87119,0,84937,1,172056,1.56900237240287,779
111,"AAC","GAC","N","D",0,87119,1,84937,1,172056,1.59948127623239,780
111,"AAC","TAC","N","Y",1,87119,0,84937,1,172056,1.56900237240287,781
112,"CAG","AAG","Q","K",5,86925,10,86233,15,173158,1.46907265854858,782
112,"CAG","CAA","Q","Q",4,86925,1,86233,5,173158,1.96719336167166,783
112,"CAG","CAC","Q","H",0,86925,2,86233,2,173158,2.30099309377893,784
112,"CAG","CAG","Q","Q",86906,86925,86212,86233,173118,173158,1,785
112,"CAG","CAT","Q","H",4,86925,5,86233,9,173158,0.885457299091056,786
112,"CAG","CGG","Q","R",2,86925,2,86233,4,173158,0.685161718172121,787
112,"CAG","CTG","Q","L",0,86925,1,86233,1,173158,1.60625137550054,788
112,"CAG","TAG","Q",".",4,86925,0,86233,4,173158,3.24268284879117,789
113,"AAG","AAA","K","K",2,85815,2,85848,4,171663,0.692867518954139,790
113,"AAG","AAC","K","N",0,85815,1,85848,1,171663,1.60899041631601,791
113,"AAG","AAG","K","K",85793,85815,85817,85848,171610,171663,1,792
113,"AAG","AAT","K","N",19,85815,22,85848,41,171663,0.842325690387559,793
113,"AAG","ACG","K","T",0,85815,1,85848,1,171663,1.60899041631601,794
113,"AAG","AGG","K","R",0,85815,1,85848,1,171663,1.60899041631601,795
113,"AAG","ATG","K","M",0,85815,1,85848,1,171663,1.60899041631601,796
113,"AAG","CAG","K","Q",0,85815,1,85848,1,171663,1.60899041631601,797
113,"AAG","GAG","K","E",1,85815,0,85848,1,171663,1.60932605717688,798
113,"AAG","TAG","K",".",0,85815,2,85848,2,171663,2.3020816457783,799
114,"CCC","ACC","P","T",3,86552,10,86257,13,172809,2.14655659644142,800
114,"CCC","CAC","P","H",3,86552,3,86257,6,172809,0.689564822726006,801
114,"CCC","CCA","P","P",5,86552,2,86257,7,172809,1.60369996369442,802
114,"CCC","CCC","P","P",86534,86552,86224,86257,172758,172809,1,803
114,"CCC","CCG","P","P",0,86552,2,86257,2,172809,2.30186964735474,804
114,"CCC","CCT","P","P",0,86552,4,86257,4,172809,3.25782142719385,805
114,"CCC","CTC","P","L",3,86552,5,86257,8,172809,1.17645198759393,806
114,"CCC","GCC","P","A",0,86552,1,86257,1,172809,1.60800650892653,807
114,"CCC","TCC","P","S",4,86552,6,86257,10,172809,1.08277016300635,808
115,"AGA","AAA","R","K",1,88475,0,88192,1,176667,1.60442206429925,809
115,"AGA","ACA","R","T",2,88475,0,88192,2,176667,2.29694049116507,810
115,"AGA","AGA","R","R",88442,88475,88165,88192,176607,176667,1,811
115,"AGA","AGG","R","R",3,88475,0,88192,3,176667,2.82730972869741,812
115,"AGA","AGT","R","S",1,88475,0,88192,1,176667,1.60442206429925,813
115,"AGA","ATA","R","I",11,88475,9,88192,20,176667,0.888300259463574,814
115,"AGA","GGA","R","G",10,88475,16,88192,26,176667,1.21851918285,815
115,"AGA","TGA","R",".",5,88475,2,88192,7,176667,1.60442206429925,816
116,"GTG","AAA","V","K",1,90376,0,86041,1,176417,1.53137800605453,817
116,"GTG","ATG","V","M",3,90376,3,86041,6,176417,0.6450782985664,818
116,"GTG","GTA","V","V",11,90376,14,86041,25,176417,0.903665881230578,819
116,"GTG","GTG","V","V",90354,90376,86009,86041,176363,176417,1,820
116,"GTG","GTT","V","V",6,90376,13,86041,19,176417,1.59048672188073,821
116,"GTG","TTG","V","L",1,90376,2,86041,3,176417,1.1493485804946,822
117,"CCT","ACT","P","T",7,90974,8,85626,15,176600,0.766248074794496,823
117,"CCT","CAT","P","H",9,90974,6,85626,15,176600,1.0325692565833,824
117,"CCT","CCA","P","P",1,90974,0,85626,1,176600,1.51385447152008,825
117,"CCT","CCC","P","P",9,90974,4,85626,13,176600,1.51385447152008,826
117,"CCT","CCG","P","P",1,90974,1,85626,2,176600,0.634486367694565,827
117,"CCT","CCT","P","P",90891,90974,85556,85626,176447,176600,1,828
117,"CCT","CTT","P","L",2,90974,0,85626,2,176600,2.19438481493467,829
117,"CCT","GCT","P","A",2,90974,0,85626,2,176600,2.19438481493467,830
117,"CCT","TCT","P","S",52,90974,51,85626,103,176600,0.652564638967782,831
118,"ACC","AAC","T","N",0,91342,1,85757,1,177099,1.58545203684762,832
118,"ACC","ACA","T","T",6,91342,5,85757,11,177099,0.788373737335157,833
118,"ACC","ACC","T","T",91329,91342,85747,85757,177076,177099,1,834
118,"ACC","ACT","T","T",2,91342,1,85757,3,177099,1.09305332198092,835
118,"ACC","AGC","T","S",1,91342,0,85757,1,177099,1.50983633474038,836
118,"ACC","ATC","T","I",3,91342,2,85757,5,177099,0.942779451710557,837
118,"ACC","TCC","T","S",1,91342,1,85757,2,177099,0.632068000512003,838
119,"CTG","ATG","L","M",6,92895,10,86927,16,179822,1.2074729586961,839
119,"CTG","CAG","L","Q",1,92895,1,86927,2,179822,0.628946310026037,840
119,"CTG","CCG","L","P",11,92895,9,86927,20,179822,0.815768187916786,841
119,"CTG","CTA","L","L",2,92895,1,86927,3,179822,1.08862077397914,842
119,"CTG","CTC","L","L",0,92895,1,86927,1,179822,1.58424998355902,843
119,"CTG","CTG","L","L",92859,92895,86893,86927,179752,179822,1,844
119,"CTG","CTT","L","L",14,92895,12,86927,26,179822,0.772782350671538,845
119,"CTG","TTG","L","L",2,92895,0,86927,2,179822,2.18388024940178,846
120,"AGG","AAG","R","K",1,92433,0,88381,1,180814,1.53861479378223,847
120,"AGG","AGA","R","R",5,92433,7,88381,12,180814,0.990399973064349,848
120,"AGG","AGG","R","R",92405,92433,88368,88381,180773,180814,1,849
120,"AGG","AGT","R","S",8,92433,3,88381,11,180814,1.72807835624068,850
120,"AGG","ATG","R","M",5,92433,2,88381,7,180814,1.53861479378223,851
120,"AGG","GGG","R","G",8,92433,1,88381,9,180814,2.97140371744057,852
120,"AGG","TGG","R","W",1,92433,0,88381,1,180814,1.53861479378223,853
121,"CAA","AAA","Q","K",19,92479,11,88573,30,181052,1.2665659774889,854
121,"CAA","CAA","Q","Q",92448,92479,88553,88573,181001,181052,1,855
121,"CAA","CAC","Q","H",2,92479,0,88573,2,181052,2.22544606454353,856
121,"CAA","CAG","Q","Q",2,92479,3,88573,5,181052,0.991505861943373,857
121,"CAA","CAT","Q","H",0,92479,1,88573,1,181052,1.59280278780564,858
121,"CAA","CGA","Q","R",1,92479,1,88573,2,181052,0.651028707967325,859
121,"CAA","GAA","Q","E",1,92479,0,88573,1,181052,1.54116967121788,860
121,"CAA","TAA","Q",".",6,92479,4,88573,10,181052,1.02902075768075,861
122,"GCA","ACA","A","T",17,94008,26,88766,43,182774,1.14465621068459,862
122,"GCA","GAA","A","E",5,94008,12,88766,17,182774,1.7202286744372,863
122,"GCA","GCA","A","A",93967,94008,88716,88766,182683,182774,1,864
122,"GCA","GCG","A","A",0,94008,2,88766,2,182774,2.29166177061881,865
122,"GCA","GTA","A","V",8,94008,5,88766,13,182774,1.10046480859586,866
122,"GCA","TCA","A","S",11,94008,5,88766,16,182774,1.51851595049099,867
123,"AAA","AAA","K","K",94163,94167,88835,88840,182998,183007,1,868
123,"AAA","AAC","K","N",1,94167,0,88840,1,183007,1.51735531703572,869
123,"AAA","AAG","K","K",0,94167,1,88840,1,183007,1.58719992538207,870
123,"AAA","AAT","K","N",1,94167,0,88840,1,183007,1.51735531703572,871
123,"AAA","ACA","K","T",0,94167,1,88840,1,183007,1.58719992538207,872
123,"AAA","AGA","K","R",0,94167,2,88840,2,183007,2.29152791420285,873
123,"AAA","ATA","K","I",0,94167,1,88840,1,183007,1.58719992538207,874
123,"AAA","CAA","K","Q",2,94167,0,88840,2,183007,2.19837230077075,875
124,"GTG","ATG","V","M",1,93831,1,88540,2,182371,0.636837394538614,876
124,"GTG","GAG","V","E",2,93831,0,88540,2,182371,2.1988269368818,877
124,"GTG","GTA","V","V",9,93831,9,88540,18,182371,0.636837394538614,878
124,"GTG","GTG","V","V",93803,93831,88518,88540,182321,182371,1,879
124,"GTG","GTT","V","V",14,93831,10,88540,24,182371,0.976773995802043,880
124,"GTG","TTG","V","L",2,93831,2,88540,4,182371,0.636837394538614,881
125,"CAA","AAA","Q","K",8,95379,2,88797,10,184176,2.17490007560229,882
125,"CAA","CAA","Q","Q",95312,95379,88738,88797,184050,184176,1,883
125,"CAA","CAC","Q","H",1,95379,2,88797,3,184176,1.13681059947025,884
125,"CAA","CAG","Q","Q",17,95379,9,88797,26,184176,1.33722753912062,885
125,"CAA","CAT","Q","H",6,95379,3,88797,9,184176,1.29598964096557,886
125,"CAA","CGA","Q","R",8,95379,7,88797,15,184176,0.740535697089587,887
125,"CAA","CTA","Q","L",1,95379,0,88797,1,184176,1.49677232160058,888
125,"CAA","TAA","Q",".",26,95379,36,88797,62,184176,1.00968150234533,889
126,"GGC","AGC","G","S",3,95260,4,87591,7,182851,0.878765572483326,890
126,"GGC","GAC","G","D",6,95260,3,87591,9,182851,1.27790578667061,891
126,"GGC","GGA","G","G",22,95260,17,87591,39,182851,0.867243216872993,892
126,"GGC","GGC","G","G",95206,95260,87539,87591,182745,182851,1,893
126,"GGC","GGT","G","G",5,95260,7,87591,12,182851,0.964396181443829,894
126,"GGC","GTC","G","V",14,95260,16,87591,30,182851,0.756060900882639,895
126,"GGC","TGC","G","C",4,95260,5,87591,9,182851,0.82655220465125,896
127,"CCT","ACT","P","T",9,97261,7,87463,16,184724,0.816912253523911,897
127,"CCT","CAT","P","H",5,97261,10,87463,15,184724,1.4278563365039,898
127,"CCT","CCC","P","P",5,97261,3,87463,8,184724,1.03653824393609,899
127,"CCT","CCG","P","P",1,97261,0,87463,1,184724,1.44327937957078,900
127,"CCT","CCT","P","P",97234,97261,87437,87463,184671,184724,1,901
127,"CCT","CTT","P","L",2,97261,2,87463,4,184724,0.592575154105107,902
127,"CCT","TCT","P","S",5,97261,4,87463,9,184724,0.772162373583906,903
128,"GCC","ACC","A","T",8,96447,9,85686,17,182133,0.705044860733018,904
128,"GCC","GAC","A","D",9,96447,5,85686,14,182133,1.16086484565486,905
128,"GCC","GCA","A","A",3,96447,1,85686,4,182133,1.42490871448393,906
128,"GCC","GCC","A","A",96399,96447,85647,85686,182046,182133,1,907
128,"GCC","GCG","A","A",1,96447,1,85686,2,182133,0.581863366181804,908
128,"GCC","GCT","A","A",4,96447,1,85686,5,182133,1.78062434588933,909
128,"GCC","GGC","A","G",0,96447,1,85686,1,182133,1.56639879043759,910
128,"GCC","GTC","A","V",12,96447,9,85686,21,182133,0.847598351697792,911
128,"GCC","TCC","A","S",11,96447,12,85686,23,182133,0.674464077284242,912
129,"TTT","ATT","F","I",10,97501,7,86460,17,183961,0.911075625696238,913
129,"TTT","CTT","F","L",4,97501,1,86460,5,183961,1.77760811369909,914
129,"TTT","GTT","F","V",4,97501,2,86460,6,183961,1.15837411753361,915
129,"TTT","TCT","F","S",2,97501,2,86460,4,183961,0.58026420427035,916
129,"TTT","TTA","F","L",1,97501,0,86460,1,183961,1.42215402078667,917
129,"TTT","TTC","F","F",5,97501,2,86460,7,183961,1.42215402078667,918
129,"TTT","TTT","F","F",97475,97501,86446,86460,183921,183961,1,919
130,"GAG","AAG","E","K",3,97874,2,84891,5,182765,0.849249013007865,920
130,"GAG","GAA","E","E",2,97874,3,84891,5,182765,0.928354141695504,921
130,"GAG","GAG","E","E",97836,97874,84873,84891,182709,182765,1,922
130,"GAG","GAT","E","D",7,97874,1,84891,8,182765,2.56809932989344,923
130,"GAG","GCG","E","A",3,97874,0,84891,3,182765,2.56809932989344,924
130,"GAG","GGG","E","G",10,97874,8,84891,18,182765,0.753395086092025,925
130,"GAG","GTG","E","V",2,97874,0,84891,2,182765,2.05066525878229,926
130,"GAG","TAG","E",".",10,97874,4,84891,14,182765,1.53523293797724,927
130,"GAG","TTG","E","L",1,97874,0,84891,1,182765,1.38885446902707,928
131,"TTC","CTC","F","L",0,99407,1,86182,1,185589,1.55850211667231,929
131,"TTC","TAC","F","Y",1,99407,0,86182,1,185589,1.38799134247823,930
131,"TTC","TCC","F","S",1,99407,0,86182,1,185589,1.38799134247823,931
131,"TTC","TTA","F","L",17,99407,13,86182,30,185589,0.807637473972183,932
131,"TTC","TTC","F","F",99379,99407,86162,86182,185541,185589,1,933
131,"TTC","TTT","F","F",9,99407,6,86182,15,185589,0.929830025516018,934
132,"GCC","ACC","A","T",30,100650,25,86204,55,186854,0.714586535584842,935
132,"GCC","GAC","A","D",12,100650,2,86204,14,186854,2.6933711654564,936
132,"GCC","GCA","A","A",6,100650,3,86204,9,186854,1.17792730621296,937
132,"GCC","GCC","A","A",100538,100650,86130,86204,186668,186854,1,938
132,"GCC","GCG","A","A",1,100650,0,86204,1,186854,1.37008562225473,939
132,"GCC","GCT","A","A",8,100650,3,86204,11,186854,1.55085064985248,940
132,"GCC","GGC","A","G",2,100650,0,86204,2,186854,2.02884501013691,941
132,"GCC","GTC","A","V",43,100650,29,86204,72,186854,0.947303850036716,942
132,"GCC","TCC","A","S",10,100650,12,86204,22,186854,0.756411201155702,943
133,"GTC","ATC","V","I",34,100207,22,85919,56,186126,0.994309807023382,944
133,"GTC","CTC","V","L",2,100207,0,85919,2,186126,2.03054150440741,945
133,"GTC","GAC","V","D",0,100207,1,85919,1,186126,1.55505706198239,946
133,"GTC","GCC","V","A",2,100207,1,85919,3,186126,0.97627614112069,947
133,"GTC","GTA","V","V",12,100207,6,85919,18,186126,1.26306128453786,948
133,"GTC","GTC","V","V",100146,100207,85878,85919,186024,186126,1,949
133,"GTC","GTT","V","V",8,100207,8,85919,16,186126,0.55121299819701,950
133,"GTC","TTC","V","F",3,100207,3,85919,6,186126,0.55121299819701,951
134,"GCA","ACA","A","T",40,100605,39,87131,79,187736,0.581092425459862,952
134,"GCA","CCA","A","P",1,100605,2,87131,3,187736,1.09861922442531,953
134,"GCA","GAA","A","E",8,100605,5,87131,13,187736,0.988628813403793,954
134,"GCA","GCA","A","A",100542,100605,87073,87131,187615,187736,1,955
134,"GCA","GCG","A","A",3,100605,1,87131,4,187736,1.38631516824717,956
134,"GCA","GTA","A","V",5,100605,3,87131,8,187736,0.988628813403793,957
134,"GCA","TCA","A","S",6,100605,8,87131,14,187736,0.876752093430737,958
135,"ATG","ACG","M","T",1,99093,1,86882,2,185975,0.570281907690559,959
135,"ATG","ATA","M","I",5,99093,4,86882,9,185975,0.745275803056685,960
135,"ATG","ATC","M","I",2,99093,0,86882,2,185975,2.06925110612195,961
135,"ATG","ATG","M","M",99076,99093,86869,86882,185945,185975,1,962
135,"ATG","ATT","M","I",8,99093,8,86882,16,185975,0.570281907690559,963
135,"ATG","GTG","M","V",1,99093,0,86882,1,185975,1.40488606906369,964
136,"ATG","ACG","M","T",1,99601,4,87038,5,186639,1.94783656601195,965
136,"ATG","ATA","M","I",3,99601,5,87038,8,186639,1.10310150232934,966
136,"ATG","ATC","M","I",2,99601,0,87038,2,186639,2.06324625850102,967
136,"ATG","ATG","M","M",99582,99601,87013,87038,186595,186639,1,968
136,"ATG","ATT","M","I",9,99601,12,87038,21,186639,0.897514727078989,969
136,"ATG","GTG","M","V",3,99601,4,87038,7,186639,0.844149158063873,970
136,"ATG","TTG","M","L",1,99601,0,87038,1,186639,1.39970199161833,971
137,"AAA","AAA","K","K",100473,100475,86511,86514,186984,186989,1,972
137,"AAA","AAG","K","K",1,100475,1,86514,2,186989,0.554682268244998,973
137,"AAA","ATA","K","I",0,100475,1,86514,1,186989,1.55632983605721,974
137,"AAA","GAA","K","E",0,100475,1,86514,1,186989,1.55632983605721,975
137,"AAA","TAA","K",".",1,100475,0,86514,1,186989,1.37764466283068,976
138,"AGG","AAG","R","K",6,101927,7,87051,13,188978,0.710762887583797,977
138,"AGG","AGA","R","R",1,101927,1,87051,2,188978,0.547786733080526,978
138,"AGG","AGG","R","R",101857,101927,86992,87051,188849,188978,1,979
138,"AGG","AGT","R","S",16,101927,8,87051,24,188978,1.28162873539258,980
138,"AGG","ATG","R","M",10,101927,13,87051,23,188978,0.854098605292828,981
138,"AGG","CGG","R","R",1,101927,1,87051,2,188978,0.547786733080526,982
138,"AGG","GGG","R","G",34,101927,29,87051,63,188978,0.689552314414252,983
138,"AGG","TGG","R","W",2,101927,0,87051,2,188978,2.02350458419137,984
139,"AAC","AAA","N","K",3,102974,5,87607,8,190581,1.08987088621203,985
139,"AAC","AAC","N","N",102960,102974,87600,87607,190560,190581,1,986
139,"AAC","AAT","N","N",7,102974,0,87607,7,190581,3.85712247517944,987
139,"AAC","ACC","N","T",1,102974,0,87607,1,190581,1.3598375226981,988
139,"AAC","AGC","N","S",2,102974,2,87607,4,190581,0.544583410093401,989
139,"AAC","GAC","N","D",1,102974,0,87607,1,190581,1.3598375226981,990
140,"TCA","CCA","S","P",1,102104,2,86274,3,188378,1.08655548744733,991
140,"TCA","TAA","S",".",23,102104,11,86274,34,188378,1.34967889458481,992
140,"TCA","TCA","S","S",102072,102104,86252,86274,188324,188378,1,993
140,"TCA","TCG","S","S",4,102104,8,86274,12,188378,1.37473955379557,994
140,"TCA","TGA","S",".",1,102104,0,86274,1,188378,1.34967889458481,995
140,"TCA","TTA","S","L",3,102104,1,86274,4,188378,1.34967889458481,996
141,"AGC","AAC","S","N",9,102563,5,87654,14,190217,1.10843146711006,997
141,"AGC","AGA","S","R",15,102563,8,87654,23,190217,1.19671758122136,998
141,"AGC","AGC","S","S",102502,102563,87617,87654,190119,190217,1,999
141,"AGC","AGG","S","R",1,102563,1,87654,2,190217,0.548501075346671,1000
141,"AGC","AGT","S","S",14,102563,7,87654,21,190217,1.27220582070927,1001
141,"AGC","ATC","S","I",12,102563,5,87654,17,190217,1.48840600658415,1002
141,"AGC","CGC","S","R",2,102563,1,87654,3,190217,0.972284651813179,1003
141,"AGC","GGC","S","G",7,102563,9,87654,16,190217,0.829929448254216,1004
141,"AGC","TGC","S","C",1,102563,1,87654,2,190217,0.548501075346671,1005
142,"ACG","AAG","T","K",3,103053,1,88068,4,191121,1.36642923940333,1006
142,"ACG","ACA","T","T",16,103053,13,88068,29,191121,0.730859759243231,1007
142,"ACG","ACG","T","T",103014,103053,88035,88068,191049,191121,1,1008
142,"ACG","ACT","T","T",7,103053,6,88068,13,191121,0.669828178897111,1009
142,"ACG","ATG","T","M",12,103053,10,88068,22,191121,0.703121733219654,1010
142,"ACG","GCG","T","A",1,103053,3,88068,4,191121,1.55399515560413,1011
143,"GTG","ATG","V","M",21,102609,10,89434,31,192043,1.39620944665271,1012
143,"GTG","CTG","V","L",1,102609,0,89434,1,192043,1.39620944665271,1013
143,"GTG","GAA","V","E",0,102609,1,89434,1,192043,1.5602401898233,1014
143,"GTG","GCG","V","A",4,102609,2,89434,6,192043,1.13494814916761,1015
143,"GTG","GTA","V","V",1,102609,0,89434,1,192043,1.39620944665271,1016
143,"GTG","GTC","V","V",1,102609,0,89434,1,192043,1.39620944665271,1017
143,"GTG","GTG","V","V",102564,102609,89411,89434,191975,192043,1,1018
143,"GTG","GTT","V","V",12,102609,10,89434,22,192043,0.723403741727399,1019
143,"GTG","TTG","V","L",5,102609,0,89434,5,192043,3.3449345138565,1020
144,"AAA","AAA","K","K",103550,103550,88416,88417,191966,191967,1,1021
144,"AAA","AAT","K","N",0,103550,1,88417,1,191967,1.5537263392665,1022
145,"ACT","AAT","T","N",7,103530,2,88683,9,192213,1.82751825652081,1023
145,"ACT","ACA","T","T",0,103530,2,88683,2,192213,2.27560872188047,1024
145,"ACT","ACC","T","T",8,103530,5,88683,13,192213,0.974991783539551,1025
145,"ACT","ACT","T","T",103512,103530,88673,88683,192185,192213,1,1026
145,"ACT","ATT","T","I",3,103530,0,88683,3,192213,2.54486270291722,1027
145,"ACT","GCT","T","A",0,103530,1,88683,1,192213,1.5547372220677,1028
146,"GAA","AAA","E","K",7,103620,3,89210,10,192830,1.37751012293742,1029
146,"GAA","CAA","E","Q",1,103620,0,89210,1,192830,1.37751012293742,1030
146,"GAA","GAA","E","E",103596,103620,89192,89210,192788,192830,1,1031
146,"GAA","GAC","E","D",0,103620,1,89210,1,192830,1.55630170629918,1032
146,"GAA","GAG","E","E",1,103620,1,89210,2,192830,0.554605675694537,1033
146,"GAA","GGA","E","G",3,103620,5,89210,8,192830,1.09569277453646,1034
146,"GAA","TAA","E",".",12,103620,8,89210,20,192830,0.934746361634129,1035
147,"TAT","AAT","Y","N",1,102609,0,88312,1,190921,1.37695970170148,1036
147,"TAT","CAT","Y","H",0,102609,2,88312,2,190921,2.27631388433611,1037
147,"TAT","TAT","Y","Y",102607,102609,88308,88312,190915,190921,1,1038
147,"TAT","TGT","Y","C",0,102609,2,88312,2,190921,2.27631388433611,1039
147,"TAT","TTT","Y","F",1,102609,0,88312,1,190921,1.37695970170148,1040
148,"GGC","AGA","G","R",0,102936,1,89842,1,192778,1.5605846159069,1041
148,"GGC","AGC","G","S",2,102936,3,89842,5,192778,0.931920712401779,1042
148,"GGC","GAC","G","D",8,102936,9,89842,17,192778,0.691231367738851,1043
148,"GGC","GGA","G","G",15,102936,14,89842,29,192778,0.624084449791283,1044
148,"GGC","GGC","G","G",102850,102936,89757,89842,192607,192778,1,1045
148,"GGC","GGG","G","G",0,102936,1,89842,1,192778,1.5605846159069,1046
148,"GGC","GGT","G","G",45,102936,42,89842,87,192778,0.626783844237751,1047
148,"GGC","GTC","G","V",12,102936,4,89842,16,192778,1.81619904069501,1048
148,"GGC","TGC","G","C",4,102936,11,89842,15,192778,1.87512037959117,1049
149,"GAG","AAG","E","K",0,102900,1,91211,1,194111,1.56565301842232,1050
149,"GAG","GAA","E","E",7,102900,7,91211,14,194111,0.579866007318307,1051
149,"GAG","GAG","E","E",102864,102900,91184,91211,194048,194111,1,1052
149,"GAG","GAT","E","D",8,102900,4,91211,12,194111,1.26581715730332,1053
149,"GAG","GGG","E","G",1,102900,1,91211,2,194111,0.579866007318307,1054
149,"GAG","GTG","E","V",0,102900,1,91211,1,194111,1.56565301842232,1055
149,"GAG","TAG","E",".",20,102900,13,91211,33,194111,1.01814239457132,1056
150,"TTT","ATT","F","I",1,102532,1,90775,2,193307,0.578759658277744,1057
150,"TTT","TCT","F","S",2,102532,1,90775,3,193307,1.0165360370316,1058
150,"TTT","TGG","F","W",0,102532,1,90775,1,193307,1.56524033246006,1059
150,"TTT","TGT","F","C",0,102532,1,90775,1,193307,1.56524033246006,1060
150,"TTT","TTC","F","F",2,102532,0,90775,2,193307,2.08622107792229,1061
150,"TTT","TTT","F","F",102527,102532,90771,90775,193298,193307,1,1062
151,"ACC","AAC","T","N",2,101686,2,91568,4,193254,0.593737754875886,1063
151,"ACC","ACA","T","T",5,101686,7,91568,12,193254,0.951086931664189,1064
151,"ACC","ACC","T","T",101649,101686,91526,91568,193175,193254,1,1065
151,"ACC","ACT","T","T",3,101686,2,91568,5,193254,0.892539895534503,1066
151,"ACC","AGC","T","S",1,101686,0,91568,1,193254,1.4452648148012,1067
151,"ACC","ATC","T","I",18,101686,26,91568,44,193254,1.04032423028488,1068
151,"ACC","GCC","T","A",8,101686,5,91568,13,193254,1.03821585215697,1069
152,"ATG","AAG","M","K",1,100639,0,92610,1,193249,1.47919057682718,1070
152,"ATG","AGG","M","R",1,100639,0,92610,1,193249,1.47919057682718,1071
152,"ATG","ATA","M","I",23,100639,11,92610,34,193249,1.47919057682718,1072
152,"ATG","ATC","M","I",1,100639,0,92610,1,193249,1.47919057682718,1073
152,"ATG","ATG","M","M",100584,100639,92589,92610,193173,193249,1,1074
152,"ATG","ATT","M","I",23,100639,9,92610,32,193249,1.77167981033928,1075
152,"ATG","GTG","M","V",6,100639,1,92610,7,193249,2.43185840085349,1076
153,"CTG","ATG","L","M",5,100813,7,93163,12,193976,0.967619280346754,1077
153,"CTG","CCG","L","P",2,100813,0,93163,2,193976,2.1616026393116,1078
153,"CTG","CTA","L","L",0,100813,5,93163,5,193976,3.60696128320554,1079
153,"CTG","CTG","L","L",100781,100813,93128,93163,193909,193976,1,1080
153,"CTG","CTT","L","L",6,100813,7,93163,13,193976,0.770115811534681,1081
153,"CTG","GTG","L","V",1,100813,1,93163,2,193976,0.617288262235656,1082
153,"CTG","TTG","L","L",18,100813,15,93163,33,193976,0.790330098226403,1083
154,"GGC","AGC","G","S",7,99256,2,93743,9,192999,1.99402249075488,1084
154,"GGC","CGC","G","R",1,99256,0,93743,1,192999,1.51931046603366,1085
154,"GGC","GAC","G","D",17,99256,12,93743,29,192999,0.997177783417564,1086
154,"GGC","GGA","G","G",19,99256,17,93743,36,192999,0.742682742522631,1087
154,"GGC","GGC","G","G",99186,99256,93691,93743,192877,192999,1,1088
154,"GGC","GGG","G","G",0,99256,1,93743,1,192999,1.58765608024407,1089
154,"GGC","GGT","G","G",9,99256,10,93743,19,192999,0.743016949516236,1090
154,"GGC","GTC","G","V",14,99256,5,93743,19,192999,1.88352967320182,1091
154,"GGC","TGC","G","C",3,99256,5,93743,8,192999,1.14494495767369,1092
155,"ATC","AAC","I","N",1,99828,0,94973,1,194801,1.53061277369239,1093
155,"ATC","ACC","I","T",2,99828,0,94973,2,194801,2.21345515382789,1094
155,"ATC","ATA","I","I",8,99828,6,94973,14,194801,0.914864438731062,1095
155,"ATC","ATC","I","I",99808,99828,94962,94973,194770,194801,1,1096
155,"ATC","ATG","I","M",2,99828,1,94973,3,194801,1.11080985087695,1097
155,"ATC","ATT","I","I",5,99828,3,94973,8,194801,1.11080985087695,1098
155,"ATC","CTC","I","L",0,99828,1,94973,1,194801,1.59030644678452,1099
155,"ATC","GTC","I","V",2,99828,0,94973,2,194801,2.21345515382789,1100
156,"TAT","AAT","Y","N",1,99318,4,94753,5,194071,1.96853918654023,1101
156,"TAT","CAT","Y","H",11,99318,8,94753,19,194071,0.962467784890978,1102
156,"TAT","GAT","Y","D",2,99318,1,94753,3,194071,1.11447596211024,1103
156,"TAT","TAC","Y","Y",1,99318,2,94753,3,194071,1.15063820101633,1104
156,"TAT","TAT","Y","Y",99300,99318,94737,94753,194037,194071,1,1105
156,"TAT","TCT","Y","S",1,99318,0,94753,1,194071,1.5348946214724,1106
156,"TAT","TGT","Y","C",2,99318,1,94753,3,194071,1.11447596211024,1107
157,"GAC","AAC","D","N",1,100553,3,94765,4,195318,1.58685360317141,1108
157,"GAC","CAC","D","H",1,100553,1,94765,2,195318,0.635700273533551,1109
157,"GAC","GAA","D","E",6,100553,3,94765,9,195318,1.31387247709926,1110
157,"GAC","GAC","D","D",100521,100553,94743,94765,195264,195318,1,1111
157,"GAC","GAT","D","D",13,100553,6,94765,19,195318,1.51586896740233,1112
157,"GAC","GGC","D","G",6,100553,2,94765,8,195318,1.76413811285985,1113
157,"GAC","TAC","D","Y",5,100553,7,94765,12,195318,0.980624912269041,1114
158,"AGG","AAG","R","K",2,98682,8,94953,10,193635,2.29512559456807,1115
158,"AGG","AGA","R","R",1,98682,7,94953,8,193635,2.82883214565533,1116
158,"AGG","AGG","R","R",98663,98682,94926,94953,193589,193635,1,1117
158,"AGG","AGT","R","S",3,98682,4,94953,7,193635,0.911552542690633,1118
158,"AGG","ATG","R","M",4,98682,2,94953,6,193635,1.27294098892131,1119
158,"AGG","CGG","R","R",1,98682,0,94953,1,193635,1.54814323012163,1120
158,"AGG","GGG","R","G",8,98682,5,94953,13,193635,1.12583364538199,1121
158,"AGG","TGG","R","W",0,98682,1,94953,1,193635,1.59446285300475,1122
159,"TGG","TAG","W",".",2,98692,1,94686,3,193378,1.12206486283211,1123
159,"TGG","TCG","W","S",1,98692,0,94686,1,193378,1.54374976293076,1124
159,"TGG","TGA","W",".",1,98692,2,94686,3,193378,1.15389831006718,1125
159,"TGG","TGG","W","W",98672,98692,94670,94686,193342,193378,1,1126
159,"TGG","TGT","W","C",5,98692,4,94686,9,193378,0.843961350499364,1127
159,"TGG","TTG","W","L",11,98692,9,94686,20,193378,0.843961350499364,1128
160,"GCC","ACC","A","T",14,98628,25,95433,39,194061,1.37118579839635,1129
160,"GCC","GAC","A","D",29,98628,48,95433,77,194061,1.28186489224371,1130
160,"GCC","GCA","A","A",3,98628,3,95433,6,194061,0.660404724862793,1131
160,"GCC","GCC","A","A",98538,98628,95311,95433,193849,194061,1,1132
160,"GCC","GCT","A","A",4,98628,6,95433,10,194061,1.06318390005513,1133
160,"GCC","GGC","A","G",1,98628,0,95433,1,194061,1.5565227152179,1134
160,"GCC","GTC","A","V",27,98628,30,95433,57,194061,0.770728796493015,1135
160,"GCC","TCC","A","S",12,98628,10,95433,22,194061,0.835823550248076,1136
161,"GTT","ATT","V","I",25,97733,26,97002,51,194735,0.724371207392322,1137
161,"GTT","CTT","V","L",0,97733,3,97002,3,194735,2.83233241812791,1138
161,"GTT","GCT","V","A",4,97733,1,97002,5,194735,1.96801304671582,1139
161,"GTT","GTC","V","V",1,97733,0,97002,1,194735,1.59739031351237,1140
161,"GTT","GTG","V","V",0,97733,1,97002,1,194735,1.60643959267075,1141
161,"GTT","GTT","V","V",97699,97733,96965,97002,194664,194735,1,1142
161,"GTT","TTT","V","F",4,97733,6,97002,10,194735,1.08011929363318,1143
162,"TTG","CTG","L","L",0,98016,1,97151,1,195167,1.60589592182561,1144
162,"TTG","TCG","L","S",1,98016,0,97151,1,195167,1.59519404789884,1145
162,"TTG","TTA","L","L",11,98016,22,97151,33,195167,1.53814220974722,1146
162,"TTG","TTG","L","L",97986,98016,97116,97151,195102,195167,1,1147
162,"TTG","TTT","L","F",18,98016,12,97151,30,195167,1.13086372663267,1148
163,"CCA","ACA","P","T",10,97046,8,97671,18,194717,0.90876573663661,1149
163,"CCA","CAA","P","Q",4,97046,4,97671,8,194717,0.686842827895327,1150
163,"CCA","CCA","P","P",96935,97046,97550,97671,194485,194717,1,1151
163,"CCA","CCG","P","P",2,97046,4,97671,6,194717,1.31985103153631,1152
163,"CCA","CTA","P","L",10,97046,9,97671,19,194717,0.787288930808459,1153
163,"CCA","GCA","P","A",0,97046,1,97671,1,194717,1.59933178200826,1154
163,"CCA","TCA","P","S",85,97046,95,97671,180,194717,0.802188536822023,1155
164,"CGC","AGC","R","S",6,94866,4,100000,10,194866,1.05078231050779,1156
164,"CGC","CAC","R","H",26,94866,29,100000,55,194866,0.747148647179329,1157
164,"CGC","CGA","R","R",6,94866,12,100000,18,194866,1.41188750483597,1158
164,"CGC","CGC","R","R",94795,94866,99929,100000,194724,194866,1,1159
164,"CGC","CGG","R","R",1,94866,0,100000,1,194866,1.5892122585765,1160
164,"CGC","CGT","R","R",8,94866,8,100000,16,194866,0.641794707181161,1161
164,"CGC","CTC","R","L",6,94866,9,100000,15,194866,1.04257274199553,1162
164,"CGC","TGC","R","C",18,94866,9,100000,27,194866,1.50627222265917,1163
165,"CAC","AAC","H","N",3,94822,3,98800,6,193622,0.652835291485536,1164
165,"CAC","CAA","H","Q",4,94822,4,98800,8,193622,0.652835291485536,1165
165,"CAC","CAC","H","H",94793,94822,98776,98800,193569,193622,1,1166
165,"CAC","CAT","H","H",18,94822,11,98800,29,193622,1.23195485834985,1167
165,"CAC","CGC","H","R",2,94822,2,98800,4,193622,0.652835291485536,1168
165,"CAC","TAC","H","Y",2,94822,4,98800,6,193622,1.26927638608761,1169
166,"GCC","ACC","A","T",52,93236,65,98615,117,191851,0.869693555494096,1170
166,"GCC","CCC","A","P",0,93236,1,98615,1,191851,1.52072777169463,1171
166,"GCC","GAC","A","D",9,93236,16,98615,25,191851,1.27629469102671,1172
166,"GCC","GCA","A","A",8,93236,6,98615,14,191851,0.934896451035695,1173
166,"GCC","GCC","A","A",93135,93236,98508,98615,191643,191851,1,1174
166,"GCC","GCG","A","A",1,93236,0,98615,1,191851,1.58798717881675,1175
166,"GCC","GCT","A","A",3,93236,2,98615,5,191851,0.982702346439139,1176
166,"GCC","GTC","A","V",7,93236,6,98615,13,191851,0.788462330610566,1177
166,"GCC","TCC","A","S",21,93236,11,98615,32,191851,1.44809466724285,1178
167,"AAA","AAA","K","K",93626,93627,98727,98730,192353,192357,1,1179
167,"AAA","AAC","K","N",1,93627,0,98730,1,192357,1.58909949928102,1180
167,"AAA","AGA","K","R",0,93627,1,98730,1,192357,1.52547795064918,1181
167,"AAA","GAA","K","E",0,93627,2,98730,2,192357,2.20761659046924,1182
168,"CCT","ACT","P","T",3,91751,5,100151,8,191902,1.06063647363642,1183
168,"CCT","CAT","P","H",9,91751,8,100151,17,191902,0.72936905357285,1184
168,"CCT","CCA","P","P",3,91751,1,100151,4,191902,1.57675021436654,1185
168,"CCT","CCC","P","P",10,91751,7,100151,17,191902,1.00423891664389,1186
168,"CCT","CCG","P","P",0,91751,2,100151,2,191902,2.14626277095444,1187
168,"CCT","CCT","P","P",91717,91751,100119,100151,191836,191902,1,1188
168,"CCT","CGT","P","R",0,91751,1,100151,1,191902,1.47174138194614,1189
168,"CCT","CTT","P","L",5,91751,5,100151,10,191902,0.609332790318912,1190
168,"CCT","TCT","P","S",4,91751,3,100151,7,191902,0.876178424922419,1191
169,"GGG","AGG","G","R",2,92513,3,100941,5,193454,0.913632869328895,1192
169,"GGG","CGG","G","R",2,92513,1,100941,3,193454,1.12817670365673,1193
169,"GGG","GAG","G","E",0,92513,1,100941,1,193454,1.47248796864457,1194
169,"GGG","GCG","G","A",0,92513,1,100941,1,193454,1.47248796864457,1195
169,"GGG","GGA","G","G",15,92513,17,100941,32,193454,0.724232462908372,1196
169,"GGG","GGG","G","G",92469,92513,100891,100941,193360,193454,1,1197
169,"GGG","GGT","G","G",17,92513,12,100941,29,193454,1.01420736891595,1198
169,"GGG","GTG","G","V",4,92513,8,100941,12,193454,1.31416878230826,1199
169,"GGG","TGG","G","W",4,92513,7,100941,11,193454,1.14754352199763,1200
170,"CCA","ACA","P","T",16,92285,35,98846,51,191131,1.5913836287803,1201
170,"CCA","CAA","P","Q",6,92285,5,98846,11,191131,0.803407358403005,1202
170,"CCA","CCA","P","P",92243,92285,98780,98846,191023,191131,1,1203
170,"CCA","CCC","P","P",0,92285,1,98846,1,191131,1.50143031146248,1204
170,"CCA","CCG","P","P",1,92285,0,98846,1,191131,1.58350986024111,1205
170,"CCA","CGA","P","R",1,92285,0,98846,1,191131,1.58350986024111,1206
170,"CCA","CTA","P","L",5,92285,5,98846,10,191131,0.62702124922955,1207
170,"CCA","GCA","P","A",0,92285,1,98846,1,191131,1.50143031146248,1208
170,"CCA","TCA","P","S",13,92285,19,98846,32,191131,1.02232316078142,1209
171,"ACC","AAC","T","N",6,94484,2,98176,8,192660,1.85170211095595,1210
171,"ACC","ACA","T","T",4,94484,9,98176,13,192660,1.54859126842533,1211
171,"ACC","ACC","T","T",94467,94484,98158,98176,192625,192660,1,1212
171,"ACC","ACT","T","T",3,94484,4,98176,7,192660,0.894945417086871,1213
171,"ACC","AGC","T","S",0,94484,2,98176,2,192660,2.23386554827702,1214
171,"ACC","ATC","T","I",3,94484,1,98176,4,192660,1.59456981090401,1215
171,"ACC","GCC","T","A",1,94484,0,98176,1,192660,1.59456981090401,1216
172,"ATC","ACC","I","T",1,93141,3,98595,4,191736,1.51940523355809,1217
172,"ATC","ATA","I","I",8,93141,8,98595,16,191736,0.63783352554959,1218
172,"ATC","ATC","I","I",93128,93141,98584,98595,191712,191736,1,1219
172,"ATC","ATG","I","M",2,93141,0,98595,2,191736,2.29176442509626,1220
172,"ATC","TTC","I","F",2,93141,0,98595,2,191736,2.29176442509626,1221
173,"TTG","ATG","L","M",0,92470,1,99818,1,192288,1.48900980953328,1222
173,"TTG","CTG","L","L",1,92470,3,99818,4,192288,1.48900980953328,1223
173,"TTG","GTG","L","V",1,92470,0,99818,1,192288,1.58066306519719,1224
173,"TTG","TAG","L",".",1,92470,1,99818,2,192288,0.61959537807806,1225
173,"TTG","TCG","L","S",1,92470,2,99818,3,192288,1.07530820209601,1226
173,"TTG","TTA","L","L",0,92470,1,99818,1,192288,1.48900980953328,1227
173,"TTG","TTG","L","L",92458,92470,99806,99818,192264,192288,1,1228
173,"TTG","TTT","L","F",8,92470,4,99818,12,192288,1.41054200422837,1229
174,"ATG","ATA","M","I",0,92992,5,99625,5,192617,3.47726636587488,1230
174,"ATG","ATC","M","I",0,92992,4,99625,4,192617,3.12612407137557,1231
174,"ATG","ATG","M","M",92982,92992,99606,99625,192588,192617,1,1232
174,"ATG","ATT","M","I",7,92992,9,99625,16,192617,0.859336529594315,1233
174,"ATG","CTG","M","L",1,92992,0,99625,1,192617,1.58338542006695,1234
174,"ATG","GTG","M","V",2,92992,1,99625,3,192617,1.13828793966097,1235
175,"AAT","AAA","N","K",1,91761,0,98794,1,190555,1.58153255691812,1236
175,"AAT","AAC","N","N",1,91761,0,98794,1,190555,1.58153255691812,1237
175,"AAT","AAT","N","N",91740,91761,98788,98794,190528,190555,1,1238
175,"AAT","AGT","N","S",2,91761,2,98794,4,190555,0.62186705875131,1240
175,"AAT","ATT","N","I",2,91761,0,98794,2,190555,2.28872975068626,1241
175,"AAT","GAT","N","D",2,91761,4,98794,6,190555,1.22246903270578,1242
175,"AAT","TAT","N","Y",2,91761,0,98794,2,190555,2.28872975068626,1243
176,"GAT","AAT","D","N",4,92996,0,98360,4,191356,3.25400358693045,1244
176,"GAT","GAA","D","E",1,92996,1,98360,2,191356,0.638585790734438,1245
176,"GAT","GAC","D","D",1,92996,0,98360,1,191356,1.58796925190098,1246
176,"GAT","GAT","D","D",92982,92996,98351,98360,191333,191356,1,1247
176,"GAT","GGT","D","G",2,92996,1,98360,3,191356,1.14543249916474,1248
176,"GAT","TAT","D","Y",6,92996,7,98360,13,191356,0.773534396473769,1249
177,"CAA","AAA","Q","K",12,92288,10,97665,22,189953,0.828350542000553,1250
177,"CAA","CAA","Q","Q",92268,92288,97648,97665,189916,189953,1,1251
177,"CAA","CAG","Q","Q",0,92288,1,97665,1,189953,1.51981505034113,1252
177,"CAA","CCA","Q","P",1,92288,0,97665,1,189953,1.58777391559818,1253
177,"CAA","CGA","Q","R",5,92288,3,97665,8,189953,1.14512841216961,1254
177,"CAA","GAA","Q","E",0,92288,2,97665,2,189953,2.20117279443205,1255
177,"CAA","TAA","Q",".",2,92288,1,97665,3,189953,1.14512841216961,1256
178,"GAG","AAG","E","K",1,91227,1,97790,2,189017,0.626107301938199,1257
178,"GAG","CAG","E","Q",1,91227,1,97790,2,189017,0.626107301938199,1258
178,"GAG","GAA","E","E",0,91227,3,97790,3,189017,2.7030412136516,1259
178,"GAG","GAG","E","E",91214,91227,97774,97790,188988,189017,1,1260
178,"GAG","GAT","E","D",3,91227,3,97790,6,189017,0.626107301938199,1261
178,"GAG","GGG","E","G",6,91227,5,97790,11,189017,0.802641258272954,1262
178,"GAG","TAG","E",".",2,91227,3,97790,5,189017,0.935005754832434,1263
179,"GTT","ATT","V","I",1,89442,3,98034,4,187476,1.46557903012241,1264
179,"GTT","GTA","V","V",0,89442,1,98034,1,187476,1.46557903012241,1265
179,"GTT","GTT","V","V",89440,89442,98025,98034,187465,187476,1,1266
179,"GTT","TTT","V","F",1,89442,5,98034,6,187476,2.13919660006911,1267
180,"GGT","AGT","G","S",3,89032,2,98090,5,187122,0.956117756925676,1268
180,"GGT","GAT","G","D",3,89032,4,98090,7,187122,0.827322289594068,1269
180,"GGT","GCT","G","A",1,89032,0,98090,1,187122,1.57356181493268,1270
180,"GGT","GGC","G","G",0,89032,1,98090,1,187122,1.45749729236708,1271
180,"GGT","GGT","G","G",89017,89032,98076,98090,187093,187122,1,1272
180,"GGT","GTT","G","V",4,89032,3,98090,7,187122,0.869743676737644,1273
180,"GGT","TGT","G","C",4,89032,4,98090,8,187122,0.600921749157181,1274
181,"GTG","ATG","V","M",4,90497,7,98686,11,189183,1.14822056164258,1275
181,"GTG","CTG","V","L",1,90497,0,98686,1,189183,1.57709049437214,1276
181,"GTG","GAG","V","E",0,90497,1,98686,1,189183,1.47325232095742,1277
181,"GTG","GCG","V","A",2,90497,1,98686,3,189183,1.1284463990311,1278
181,"GTG","GTA","V","V",4,90497,4,98686,8,189183,0.61022786648997,1279
181,"GTG","GTG","V","V",90470,90497,98661,98686,189131,189183,1,1280
181,"GTG","GTT","V","V",11,90497,8,98686,19,189183,0.962650744467689,1281
181,"GTG","TTG","V","L",5,90497,4,98686,9,189183,0.824548539676687,1282
182,"CTA","ATA","L","I",10,90446,10,99104,20,189550,0.605819442194774,1283
182,"CTA","CAA","L","Q",1,90446,1,99104,2,189550,0.605819442194774,1284
182,"CTA","CCA","L","P",1,90446,2,99104,3,189550,1.05559873322618,1285
182,"CTA","CTA","L","L",90402,90446,99065,99104,189467,189550,1,1286
182,"CTA","CTG","L","L",4,90446,1,99104,5,189550,1.95766273453384,1287
182,"CTA","CTT","L","L",1,90446,0,99104,1,189550,1.57541637339732,1288
182,"CTA","TTA","L","L",27,90446,25,99104,52,189550,0.689398534568941,1289
183,"GAT","AAT","D","N",0,88243,1,98677,1,186920,1.43484235082294,1290
183,"GAT","GAT","D","D",88239,88243,98670,98677,186909,186920,1,1291
183,"GAT","TAT","D","Y",4,88243,6,98677,10,186920,0.942933311425077,1292
184,"GCC","ACC","A","T",12,86583,24,97597,36,184180,1.36395156313876,1293
184,"GCC","GAC","A","D",6,86583,12,97597,18,184180,1.31248325509925,1294
184,"GCC","GCA","A","A",2,86583,5,97597,7,184180,1.42291747069845,1295
184,"GCC","GCC","A","A",86517,86583,97506,97597,184023,184180,1,1296
184,"GCC","GCT","A","A",2,86583,3,97597,5,184180,0.87532205842613,1297
184,"GCC","GTC","A","V",34,86583,29,97597,63,184180,0.764729480818086,1298
184,"GCC","TCC","A","S",10,86583,18,97597,28,184180,1.20862976515431,1299
185,"AAG","AAA","K","K",3,85012,2,97813,5,182825,0.929469089480927,1300
185,"AAG","AAG","K","K",84999,85012,97798,97813,182797,182825,1,1301
185,"AAG","AAT","K","N",5,85012,8,97813,13,182825,0.993110599574272,1302
185,"AAG","ACG","K","T",1,85012,0,97813,1,182825,1.55927790392803,1303
185,"AAG","AGG","K","R",2,85012,1,97813,3,182825,1.10040606535158,1304
185,"AAG","ATG","K","M",2,85012,2,97813,4,182825,0.562688866554244,1305
185,"AAG","CAG","K","Q",0,85012,1,97813,1,182825,1.39166606702909,1306
185,"AAG","GAG","K","E",0,85012,1,97813,1,182825,1.39166606702909,1307
186,"GAG","AAG","E","K",1,86130,1,99070,2,185200,0.562986846011939,1308
186,"GAG","CAG","E","Q",1,86130,0,99070,1,185200,1.55938790933326,1309
186,"GAG","GAA","E","E",0,86130,3,99070,3,185200,2.57219602921997,1310
186,"GAG","GAG","E","E",86110,86130,99042,99070,185152,185200,1,1311
186,"GAG","GAT","E","D",10,86130,16,99070,26,185200,1.03155906240204,1312
186,"GAG","GGG","E","G",5,86130,3,99070,8,185200,1.10058011999912,1313
186,"GAG","TAG","E",".",3,86130,5,99070,8,185200,0.993546521892281,1314
187,"CTA","ATA","L","I",10,84858,11,98517,21,183375,0.632890124219982,1315
187,"CTA","CCA","L","P",2,84858,6,98517,8,183375,1.61736528814105,1316
187,"CTA","CTA","L","L",84831,84858,98481,98517,183312,183375,1,1317
187,"CTA","CTG","L","L",1,84858,1,98517,2,183375,0.555035631334454,1318
187,"CTA","TTA","L","L",14,84858,18,98517,32,183375,0.784131050388336,1319
188,"GTA","ATA","V","I",3,84496,2,96976,5,181472,0.930978001521474,1320
188,"GTA","CTA","V","L",1,84496,2,96976,3,181472,0.996293650659287,1321
188,"GTA","GAA","V","E",1,84496,1,96976,2,181472,0.564865621231024,1322
188,"GTA","GTA","V","V",84489,84496,96966,96976,181455,181472,1,1323
188,"GTA","GTC","V","V",1,84496,0,96976,1,181472,1.56008197514298,1324
188,"GTA","GTG","V","V",0,84496,3,96976,3,181472,2.57622264061674,1325
188,"GTA","TTA","V","L",1,84496,2,96976,3,181472,0.996293650659287,1326
189,"GAC","AAC","D","N",1,87005,1,97474,2,184479,0.585962880333764,1327
189,"GAC","GAA","D","E",6,87005,4,97474,10,184479,1.01404163234197,1328
189,"GAC","GAC","D","D",86991,87005,97459,97474,184450,184479,1,1329
189,"GAC","GAT","D","D",2,87005,3,97474,5,184479,0.882275282791252,1330
189,"GAC","TAC","D","Y",5,87005,7,97474,12,184479,0.882275282791252,1331
190,"AAG","AAA","K","K",6,86269,6,97590,12,183859,0.577488835735925,1332
190,"AAG","AAG","K","K",86238,86269,97548,97590,183786,183859,1,1333
190,"AAG","AAT","K","N",17,86269,24,97590,41,183859,0.919340875982928,1334
190,"AAG","ACG","K","T",2,86269,1,97590,3,183859,1.10907701574096,1335
190,"AAG","AGG","K","R",3,86269,7,97590,10,183859,1.41736563209951,1336
190,"AAG","ATG","K","M",2,86269,0,97590,2,183859,2.28049888049261,1337
190,"AAG","GAG","K","E",0,86269,3,97590,3,183859,2.60305586608232,1338
190,"AAG","GGG","K","G",0,86269,1,97590,1,183859,1.41736563209951,1339
190,"AAG","TAG","K",".",1,86269,0,97590,1,183859,1.56476664844949,1340
191,"GAC","AAC","D","N",5,86438,2,98789,7,185227,1.56138268462663,1341
191,"GAC","CAC","D","H",0,86438,1,98789,1,185227,1.40158264270958,1342
191,"GAC","GAA","D","E",2,86438,2,98789,4,185227,0.568380547937029,1343
191,"GAC","GAC","D","D",86406,86438,98764,98789,185170,185227,1,1344
191,"GAC","GAT","D","D",15,86438,12,98789,27,185227,0.824262564003294,1345
191,"GAC","GCC","D","A",1,86438,0,98789,1,185227,1.56138268462663,1346
191,"GAC","GGC","D","G",6,86438,3,98789,9,185227,1.34231785082385,1347
191,"GAC","TAC","D","Y",3,86438,5,98789,8,185227,1.001426757956,1348
192,"GGC","AAC","G","N",1,85514,0,96741,1,182255,1.56473720595489,1349
192,"GGC","AGC","G","S",9,85514,12,96741,21,182255,0.84182440685474,1350
192,"GGC","CGC","G","R",1,85514,0,96741,1,182255,1.56473720595489,1351
192,"GGC","GAC","G","D",40,85514,42,96741,82,182255,0.620314938184323,1352
192,"GGC","GGA","G","G",14,85514,17,96741,31,182255,0.753885804937146,1353
192,"GGC","GGC","G","G",85432,85514,96645,96741,182077,182255,1,1354
192,"GGC","GGT","G","G",10,85514,17,96741,27,182255,1.12894511148351,1355
192,"GGC","GTC","G","V",5,85514,3,96741,8,182255,1.10903057685554,1356
192,"GGC","TGC","G","C",2,85514,5,96741,7,182255,1.41722915075685,1357
193,"ACC","AAC","T","N",0,85393,3,98106,3,183499,2.57442979144988,1358
193,"ACC","ACA","T","T",3,85393,8,98106,11,183499,1.57609953833836,1359
193,"ACC","ACC","T","T",85382,85393,98086,98106,183468,183499,1,1360
193,"ACC","ACT","T","T",1,85393,7,98106,8,183499,2.57442979144988,1361
193,"ACC","ATC","T","I",6,85393,1,98106,7,183499,2.56554452504258,1362
193,"ACC","GCC","T","A",1,85393,0,98106,1,183499,1.55977265659218,1363
193,"ACC","TCC","T","S",0,85393,1,98106,1,183499,1.39400404644163,1364
194,"AAC","AAA","N","K",5,86938,1,96699,6,183637,2.2832232252564,1365
194,"AAC","AAC","N","N",86931,86938,96695,96699,183626,183637,1,1366
194,"AAC","AAG","N","K",0,86938,1,96699,1,183637,1.44290500187897,1367
194,"AAC","AAT","N","N",1,86938,1,96699,2,183637,0.592356038953969,1368
194,"AAC","ATC","N","I",1,86938,0,96699,1,183637,1.57033188089206,1369
194,"AAC","GAC","N","D",0,86938,1,96699,1,183637,1.44290500187897,1370
195,"TTA","ATA","L","I",0,85349,1,97979,1,183328,1.39512742464135,1371
195,"TTA","CTA","L","L",2,85349,4,97979,6,183328,1.13397245241602,1372
195,"TTA","GTA","L","V",1,85349,1,97979,2,183328,0.564672802595251,1373
195,"TTA","TAA","L",".",1,85349,0,97979,1,183328,1.56001070532632,1374
195,"TTA","TCA","L","S",0,85349,4,97979,4,183328,2.99432151658523,1375
195,"TTA","TTA","L","L",85343,85349,97968,97979,183311,183328,1,1376
195,"TTA","TTG","L","L",2,85349,1,97979,3,183328,1.10156532088831,1377
196,"GAA","GAA","E","E",85033,85049,97900,97917,182933,182966,1,1378
196,"GAA","GAG","E","E",1,85049,1,97917,2,182966,0.562136108539588,1379
196,"GAA","GGA","E","G",0,85049,3,97917,3,182966,2.57036986913074,1380
196,"GAA","TAA","E",".",15,85049,13,97917,28,182966,0.722967391700674,1381
197,"CTG","ATG","L","M",2,85774,1,98258,3,184032,1.10255631761898,1382
197,"CTG","CCG","L","P",7,85774,5,98258,12,184032,0.932019672329447,1383
197,"CTG","CGG","L","R",0,85774,1,98258,1,184032,1.3980800864125,1384
197,"CTG","CTA","L","L",4,85774,5,98258,9,184032,0.740542014027612,1385
197,"CTG","CTG","L","L",85748,85774,98240,98258,183988,184032,1,1386
197,"CTG","CTT","L","L",10,85774,4,98258,14,184032,1.72309787332844,1387
197,"CTG","TTG","L","L",3,85774,2,98258,5,184032,0.932019672329447,1388
198,"ACA","AAA","T","K",4,86538,2,99523,6,186061,1.26239373963502,1389
198,"ACA","ACA","T","T",86530,86538,99513,99523,186043,186061,1,1390
198,"ACA","ACG","T","T",1,86538,0,99523,1,186061,1.55942648223591,1391
198,"ACA","AGA","T","R",0,86538,1,99523,1,186061,1.39236863442151,1392
198,"ACA","ATA","T","I",3,86538,5,99523,8,186061,0.993699342464848,1393
198,"ACA","GCA","T","A",0,86538,2,99523,2,186061,2.05474339192287,1394
199,"CTA","ATA","L","I",1,86592,3,98802,4,185394,1.40422622900217,1395
199,"CTA","CAA","L","Q",0,86592,1,98802,1,185394,1.40422622900217,1396
199,"CTA","CCA","L","P",2,86592,0,98802,2,185394,2.27912132000912,1397
199,"CTA","CGA","L","R",1,86592,0,98802,1,185394,1.56194656236251,1398
199,"CTA","CTA","L","L",86583,86592,98793,98802,185376,185394,1,1399
199,"CTA","CTT","L","L",3,86592,0,98802,3,185394,2.81947789072999,1400
199,"CTA","TTA","L","L",2,86592,5,98802,7,185394,1.40422622900217,1401
200,"CTC","ATC","L","I",3,87366,6,99672,9,187038,1.20995877179669,1402
200,"CTC","CAC","L","H",2,87366,1,99672,3,187038,1.10474002234048,1403
200,"CTC","CCC","L","P",2,87366,3,99672,5,187038,0.861249333865999,1404
200,"CTC","CGC","L","R",1,87366,1,99672,2,187038,0.570097598415977,1405
200,"CTC","CTA","L","L",4,87366,11,99672,15,187038,1.69124134467894,1406
200,"CTC","CTC","L","L",87352,87366,99648,99672,187000,187038,1,1407
200,"CTC","CTT","L","L",1,87366,1,99672,2,187038,0.570097598415977,1408
200,"CTC","TTC","L","F",1,87366,1,99672,2,187038,0.570097598415977,1409
201,"AAA","AAA","K","K",88027,88032,98381,98383,186408,186415,1,1410
201,"AAA","AAG","K","K",2,88032,0,98383,2,186415,2.28244262826034,1411
201,"AAA","AAT","K","N",2,88032,2,98383,4,186415,0.588114608403123,1412
201,"AAA","GAA","K","E",1,88032,0,98383,1,186415,1.56873890933022,1413
202,"TTG","ATG","L","M",2,87625,0,98150,2,185775,2.28207232579965,1414
202,"TTG","CTG","L","L",1,87625,0,98150,1,185775,1.56798277673681,1415
202,"TTG","TTA","L","L",1,87625,3,98150,4,185775,1.43218688759855,1416
202,"TTG","TTC","L","F",0,87625,1,98150,1,185775,1.43218688759855,1417
202,"TTG","TTG","L","L",87605,87625,98132,98150,185737,185775,1,1418
202,"TTG","TTT","L","F",16,87625,14,98150,30,185775,0.733043784802306,1419
203,"AAC","AAA","N","K",4,88017,7,97034,11,185051,1.13348421995489,1420
203,"AAC","AAC","N","N",87998,88017,97010,97034,185008,185051,1,1421
203,"AAC","AAG","N","K",1,88017,2,97034,3,185051,1.04780377751604,1422
203,"AAC","AAT","N","N",11,88017,12,97034,23,185051,0.675843316870865,1423
203,"AAC","AGC","N","S",1,88017,3,97034,4,185051,1.45660037125976,1424
203,"AAC","TAC","N","Y",2,88017,0,97034,2,185051,2.2847099228035,1425
204,"CGG","AGG","R","R",7,87789,3,96647,10,184436,1.57379112313939,1426
204,"CGG","CAG","R","Q",8,87789,8,96647,16,184436,0.601528136215772,1427
204,"CGG","CGA","R","R",1,87789,4,96647,5,184436,1.81737175503845,1428
204,"CGG","CGG","R","R",87738,87789,96602,96647,184340,184436,1,1429
204,"CGG","CGT","R","R",16,87789,11,96647,27,184436,1.04093014446544,1430
204,"CGG","CTG","R","L",6,87789,7,96647,13,184436,0.731130314858864,1431
204,"CGG","GGG","R","G",1,87789,0,96647,1,184436,1.57379112313939,1432
204,"CGG","TGG","R","W",12,87789,12,96647,24,184436,0.601528136215772,1433
205,"AAT","AAT","N","N",88121,88128,95454,95454,183575,183582,1,1434
205,"AAT","ACT","N","T",3,88128,0,95454,3,183582,2.82448468170125,1435
205,"AAT","AGT","N","S",2,88128,0,95454,2,183582,2.28770071529334,1436
205,"AAT","ATT","N","I",1,88128,0,95454,1,183582,1.5794442606761,1437
205,"AAT","GAT","N","D",1,88128,0,95454,1,183582,1.5794442606761,1438
206,"GAG","AAG","E","K",2,88258,2,95516,4,183774,0.617125927017503,1439
206,"GAG","GAA","E","E",1,88258,1,95516,2,183774,0.617125927017503,1440
206,"GAG","GAC","E","D",0,88258,2,95516,2,183774,2.16129074997967,1441
206,"GAG","GAG","E","E",88226,88258,95493,95516,183719,183774,1,1442
206,"GAG","GAT","E","D",8,88258,6,95516,14,183774,0.918948892541479,1443
206,"GAG","GGG","E","G",6,88258,3,95516,9,183774,1.36509447752259,1444
206,"GAG","GTG","E","V",2,88258,0,95516,2,183774,2.28783616199853,1445
206,"GAG","TAG","E",".",13,88258,9,95516,22,183774,1.03446232040112,1446
207,"AAG","AAA","K","K",2,88893,1,95115,3,184008,1.13892208484511,1447
207,"AAG","AAG","K","K",88883,88893,95107,95115,183990,184008,1,1448
207,"AAG","AAT","K","N",3,88893,3,95115,6,184008,0.627754849710453,1449
207,"AAG","AGG","K","R",0,88893,1,95115,1,184008,1.50265397532559,1450
207,"AAG","GAG","K","E",4,88893,2,95115,6,184008,1.2950497368791,1451
207,"AAG","TAG","K",".",1,88893,1,95115,2,184008,0.627754849710453,1452
208,"TTC","CTC","F","L",0,89124,1,95149,1,184273,1.50631795276474,1453
208,"TTC","TAC","F","Y",0,89124,1,95149,1,184273,1.50631795276474,1454
208,"TTC","TTA","F","L",7,89124,9,95149,16,184273,0.863366800429836,1455
208,"TTC","TTC","F","F",89116,89124,95132,95149,184248,184273,1,1456
208,"TTC","TTG","F","L",0,89124,2,95149,2,184273,2.18579405968151,1457
208,"TTC","TTT","F","F",1,89124,4,95149,5,184273,1.86941804037309,1458
209,"AGA","AAA","R","K",0,88726,2,94407,2,183133,2.19181150465115,1459
209,"AGA","ACA","R","T",0,88726,1,94407,1,183133,1.51159611842157,1460
209,"AGA","AGA","R","R",88706,88726,94374,94407,183080,183133,1,1461
209,"AGA","AGC","R","S",0,88726,1,94407,1,183133,1.51159611842157,1462
209,"AGA","AGG","R","R",1,88726,3,94407,4,183133,1.51159611842157,1463
209,"AGA","ATA","R","I",4,88726,7,94407,11,183133,1.18225942415994,1464
209,"AGA","CGA","R","R",0,88726,3,94407,3,183133,2.71706590706019,1465
209,"AGA","GGA","R","G",14,88726,16,94407,30,183133,0.75837033665531,1466
209,"AGA","TGA","R",".",1,88726,0,94407,1,183133,1.5858602183899,1467
210,"GAC","AAC","D","N",0,89452,1,94063,1,183515,1.52981290565262,1468
210,"GAC","GAA","D","E",3,89452,4,94063,7,183515,0.880876107472883,1469
210,"GAC","GAC","D","D",89436,89452,94048,94063,183484,183515,1,1470
210,"GAC","GAT","D","D",3,89452,1,94063,4,183515,1.59011812483762,1471
210,"GAC","GGC","D","G",2,89452,0,94063,2,183515,2.2929718552443,1472
210,"GAC","TAC","D","Y",8,89452,9,94063,17,183515,0.749742325041175,1473
211,"ATC","ACC","I","T",1,89968,2,93248,3,183216,1.12958817036846,1474
211,"ATC","ATA","I","I",1,89968,5,93248,6,183216,2.23831613745328,1475
211,"ATC","ATC","I","I",89952,89968,93234,93248,183186,183216,1,1476
211,"ATC","ATG","I","M",2,89968,1,93248,3,183216,1.15714417821645,1477
211,"ATC","ATT","I","I",11,89968,5,93248,16,183216,1.59550862699214,1478
211,"ATC","CTC","I","L",1,89968,0,93248,1,183216,1.59550862699214,1479
211,"ATC","GTC","I","V",0,89968,1,93248,1,183216,1.55251735436264,1480
212,"AGA","AAA","R","K",2,88936,3,90521,5,179457,0.999181503118492,1481
212,"AGA","ACA","R","T",1,88936,0,90521,1,179457,1.60247020048475,1482
212,"AGA","AGA","R","R",88923,88936,90508,90521,179431,179457,1,1483
212,"AGA","AGG","R","R",2,88936,3,90521,5,179457,0.999181503118492,1484
212,"AGA","AGT","R","S",2,88936,1,90521,3,179457,1.16791523294877,1485
212,"AGA","ATA","R","I",3,88936,2,90521,5,179457,1.00907419827944,1486
212,"AGA","GGA","R","G",3,88936,4,90521,7,179457,0.919586875725982,1487
213,"GGC","AGC","G","S",1,89893,1,90624,2,180517,0.68484668925098,1488
213,"GGC","GAC","G","D",5,89893,5,90624,10,180517,0.68484668925098,1489
213,"GGC","GGA","G","G",26,89893,9,90624,35,180517,2.11305373496958,1490
213,"GGC","GGC","G","G",89843,89893,90595,90624,180438,180517,1,1491
213,"GGC","GGG","G","G",1,89893,0,90624,1,180517,1.60612597909327,1492
213,"GGC","GGT","G","G",1,89893,1,90624,2,180517,0.68484668925098,1493
213,"GGC","GTC","G","V",12,89893,11,90624,23,180517,0.768754915841834,1494
213,"GGC","TGC","G","C",4,89893,2,90624,6,180517,1.32475015336984,1495
214,"TTC","ATC","F","I",1,89464,0,91186,1,180650,1.60191806555556,1496
214,"TTC","CTC","F","L",0,89464,1,91186,1,180650,1.57901316386438,1497
214,"TTC","TAC","F","Y",0,89464,1,91186,1,180650,1.57901316386438,1498
214,"TTC","TCC","F","S",2,89464,0,91186,2,180650,2.29883223805025,1499
214,"TTC","TTA","F","L",5,89464,4,91186,9,180650,0.876527252826299,1500
214,"TTC","TTC","F","F",89454,89464,91178,91186,180632,180650,1,1501
214,"TTC","TTT","F","F",2,89464,2,91186,4,180650,0.674240460717497,1502
215,"TTA","ATA","L","I",1,89505,2,89934,3,179439,1.17204358692949,1503
215,"TTA","CTA","L","L",1,89505,2,89934,3,179439,1.17204358692949,1504
215,"TTA","GTA","L","V",1,89505,0,89934,1,179439,1.60753243532747,1505
215,"TTA","TAA","L",".",0,89505,1,89934,1,179439,1.60179412160697,1506
215,"TTA","TCA","L","S",2,89505,0,89934,2,179439,2.30163280829604,1507
215,"TTA","TTA","L","L",89497,89505,89926,89934,179423,179439,1,1508
215,"TTA","TTG","L","L",2,89505,3,89934,5,179439,1.01554089621995,1509
215,"TTA","TTT","L","F",1,89505,0,89934,1,179439,1.60753243532747,1510
216,"GCC","ACC","A","T",2,90798,2,88317,4,179115,0.665955908360737,1511
216,"GCC","CCC","A","P",0,90798,1,88317,1,179115,1.59864996416018,1512
216,"GCC","GAC","A","D",13,90798,8,88317,21,179115,1.19086742233342,1513
216,"GCC","GCA","A","A",4,90798,2,88317,6,179115,1.28888836248392,1514
216,"GCC","GCC","A","A",90752,90798,88284,88317,179036,179115,1,1515
216,"GCC","GCG","A","A",0,90798,2,88317,2,179115,2.29720566626504,1516
216,"GCC","GCT","A","A",1,90798,0,88317,1,179115,1.56556975370159,1517
216,"GCC","GGC","A","G",1,90798,0,88317,1,179115,1.56556975370159,1518
216,"GCC","GTC","A","V",11,90798,12,88317,23,179115,0.751397822421531,1519
216,"GCC","TCC","A","S",14,90798,6,88317,20,179115,1.67625236363767,1520
217,"AAG","AAA","K","K",4,90471,2,87837,6,178308,1.28602237337944,1521
217,"AAG","AAG","K","K",90458,90471,87824,87837,178282,178308,1,1522
217,"AAG","AAT","K","N",4,90471,6,87837,10,178308,1.065610862591,1523
217,"AAG","ACG","K","T",1,90471,0,87837,1,178308,1.56243983462789,1524
217,"AAG","AGG","K","R",3,90471,1,87837,4,178308,1.56243983462789,1525
217,"AAG","ATG","K","M",1,90471,2,87837,3,178308,1.16083924626765,1526
217,"AAG","GAG","K","E",0,90471,2,87837,2,178308,2.29682971648448,1527
218,"GAG","AAG","E","K",0,90641,1,87123,1,177764,1.59409860597935,1528
218,"GAG","GAA","E","E",3,90641,1,87123,4,177764,1.54661628018,1529
218,"GAG","GAG","E","E",90623,90641,87106,87123,177729,177764,1,1530
218,"GAG","GAT","E","D",5,90641,6,87123,11,177764,0.826365944885611,1531
218,"GAG","GGG","E","G",6,90641,3,87123,9,177764,1.34271052658553,1532
218,"GAG","GTG","E","V",0,90641,1,87123,1,177764,1.59409860597935,1533
218,"GAG","TAG","E",".",4,90641,5,87123,9,177764,0.860308020314459,1534
219,"GAA","AAA","E","K",3,90287,0,85626,3,175913,2.73389486071863,1535
219,"GAA","GAA","E","E",90269,90287,85615,85626,175884,175913,1,1536
219,"GAA","GAC","E","D",2,90287,0,85626,2,175913,2.20782449342975,1537
219,"GAA","GAG","E","E",0,90287,2,85626,2,175913,2.29248881498604,1538
219,"GAA","GAT","E","D",1,90287,1,85626,2,175913,0.641614480210811,1539
219,"GAA","GGA","E","G",3,90287,1,85626,4,175913,1.52566073232631,1540
219,"GAA","TAA","E",".",9,90287,7,85626,16,175913,0.877774139796202,1541
220,"GTG","ATG","V","M",6,90486,2,86065,8,176551,1.7791081732613,1542
220,"GTG","GCG","V","A",1,90486,1,86065,2,176551,0.64422629367469,1543
220,"GTG","GTA","V","V",0,90486,2,86065,2,176551,2.29299050432118,1544
220,"GTG","GTG","V","V",90475,90486,86047,86065,176522,176551,1,1545
220,"GTG","TTG","V","L",4,90486,4,86065,8,176551,0.64422629367469,1547
221,"GAG","AAG","E","K",1,93392,1,85115,2,178507,0.604603839406238,1548
221,"GAG","CAG","E","Q",0,93392,1,85115,1,178507,1.57495554714071,1549
221,"GAG","GAA","E","E",2,93392,3,85115,5,178507,0.958700454873462,1550
221,"GAG","GAG","E","E",93359,93392,85081,85115,178440,178507,1,1551
221,"GAG","GAT","E","D",5,93392,9,85115,14,178507,1.28323803887483,1552
221,"GAG","GCG","E","A",0,93392,2,85115,2,178507,2.28549253217392,1553
221,"GAG","GGG","E","G",13,93392,8,85115,21,178507,1.1018304340589,1554
221,"GAG","GTG","E","V",3,93392,3,85115,6,178507,0.604603839406238,1555
221,"GAG","TAG","E",".",9,93392,7,85115,16,178507,0.831907862741987,1556
222,"GTT","ATT","V","I",2,93493,4,84703,6,178196,1.28041287320395,1557
222,"GTT","GAT","V","D",0,93493,1,84703,1,178196,1.57284596085189,1558
222,"GTT","GTA","V","V",0,93493,2,84703,2,178196,2.28445647923112,1559
222,"GTT","GTT","V","V",93486,93493,84673,84703,178159,178196,1,1561
222,"GTT","TTT","V","F",5,93493,3,84703,8,178196,1.04583762522216,1562
223,"AAT","AAA","N","K",0,93281,1,84277,1,177558,1.57201116253868,1563
223,"AAT","AAC","N","N",1,93281,2,84277,3,177558,1.12047973438745,1564
223,"AAT","AAT","N","N",93270,93281,84270,84277,177540,177558,1,1565
223,"AAT","AGT","N","S",4,93281,1,84277,5,177558,1.80862157643259,1566
223,"AAT","ATT","N","I",1,93281,1,84277,2,177558,0.596815158443636,1567
223,"AAT","GAT","N","D",3,93281,1,84277,4,177558,1.4505123983928,1568
223,"AAT","TAT","N","Y",1,93281,1,84277,2,177558,0.596815158443636,1569
223,"AAT","TTT","N","F",1,93281,0,84277,1,177558,1.4505123983928,1570
224,"GAG","AAG","E","K",3,93178,2,83238,5,176416,0.883240631358192,1571
224,"GAG","GAA","E","E",2,93178,4,83238,6,176416,1.27419192304963,1572
224,"GAG","GAG","E","E",93134,93178,83199,83238,176333,176416,1,1573
224,"GAG","GAT","E","D",6,93178,6,83238,12,176416,0.586693253074409,1574
224,"GAG","GCG","E","A",3,93178,1,83238,4,176416,1.43320937239571,1575
224,"GAG","GGG","E","G",15,93178,13,83238,28,176416,0.714090691374811,1576
224,"GAG","GTG","E","V",4,93178,5,83238,9,176416,0.805597325738802,1577
224,"GAG","TAG","E",".",11,93178,8,83238,19,176416,0.883240631358192,1578
225,"GCA","ACA","A","T",6,92786,7,84182,13,176968,0.755676280929788,1579
225,"GCA","CCA","A","P",2,92786,0,84182,2,176968,2.12898806463097,1580
225,"GCA","GAA","A","E",9,92786,11,84182,20,176968,0.816659737394012,1581
225,"GCA","GCA","A","A",92744,92786,84133,84182,176877,176968,1,1582
225,"GCA","GCG","A","A",5,92786,5,84182,10,176968,0.600444232239211,1583
225,"GCA","GCT","A","A",0,92786,3,84182,3,176968,2.82274274308388,1584
225,"GCA","GTA","A","V",10,92786,12,84182,22,176968,0.797337199002436,1585
225,"GCA","TCA","A","S",10,92786,11,84182,21,176968,0.699631645276706,1586
226,"GTG","ATG","V","M",4,91267,7,83719,11,174986,1.22421421381739,1587
226,"GTG","GCG","V","A",0,91267,1,83719,1,174986,1.57722297627335,1588
226,"GTG","GGG","V","G",0,91267,1,83719,1,174986,1.57722297627335,1589
226,"GTG","GTA","V","V",10,91267,1,83719,11,174986,3.27545041735836,1590
226,"GTG","GTG","V","V",91240,91267,83697,83719,174937,174986,1,1591
226,"GTG","GTT","V","V",10,91267,10,83719,20,174986,0.610576214055265,1592
226,"GTG","TTG","V","L",3,91267,2,83719,5,174986,0.914683885543336,1593
227,"CTA","ATA","L","I",9,92220,9,85022,18,177242,0.615238222453931,1594
227,"CTA","CCA","L","P",3,92220,3,85022,6,177242,0.615238222453931,1595
227,"CTA","CTA","L","L",92187,92220,84997,85022,177184,177242,1,1596
227,"CTA","CTG","L","L",5,92220,2,85022,7,177242,1.4816929749961,1597
227,"CTA","CTT","L","L",1,92220,0,85022,1,177242,1.4816929749961,1598
227,"CTA","TTA","L","L",15,92220,11,85022,26,177242,0.920794198627455,1599
228,"GCA","ACA","A","T",19,93216,16,85132,35,178348,0.767522683867777,1600
228,"GCA","CCA","A","P",0,93216,1,85132,1,178348,1.5756888087547,1601
228,"GCA","GAA","A","E",7,93216,9,85132,16,178348,0.874038640870918,1602
228,"GCA","GCA","A","A",93178,93216,85097,85132,178275,178348,1,1603
228,"GCA","GTA","A","V",5,93216,3,85132,8,178348,1.05662920309786,1604
228,"GCA","TCA","A","S",7,93216,6,85132,13,178348,0.736875909776461,1605
229,"ATT","AAT","I","N",1,91968,0,85816,1,177784,1.50030439738495,1606
229,"ATT","ACT","I","T",0,91968,1,85816,1,177784,1.58325067493491,1607
229,"ATT","ATA","I","I",1,91968,0,85816,1,177784,1.50030439738495,1608
229,"ATT","ATC","I","I",1,91968,1,85816,2,177784,0.626346568479298,1609
229,"ATT","ATT","I","I",91962,91968,85814,85816,177776,177784,1,1610
229,"ATT","CTT","I","L",3,91968,0,85816,3,177784,2.70352089055694,1611
230,"AAC","AAA","N","K",1,92117,4,85947,5,178064,1.96296930174417,1612
230,"AAC","AAC","N","N",92111,92117,85937,85947,178048,178064,1,1613
230,"AAC","AAT","N","N",1,92117,1,85947,2,178064,0.626172861620186,1614
230,"AAC","ACC","N","T",0,92117,1,85947,1,178064,1.58318396115288,1615
230,"AAC","AGC","N","S",2,92117,2,85947,4,178064,0.626172861620186,1616
230,"AAC","ATC","N","I",0,92117,1,85947,1,178064,1.58318396115288,1617
230,"AAC","CCC","N","P",1,92117,0,85947,1,178064,1.50001443134274,1618
230,"AAC","GAC","N","D",1,92117,0,85947,1,178064,1.50001443134274,1619
230,"AAC","TAC","N","Y",0,92117,1,85947,1,178064,1.58318396115288,1620
231,"ACC","AAC","T","N",5,93320,3,85558,8,178878,1.06169577176067,1621
231,"ACC","ACA","T","T",3,93320,2,85558,5,178878,0.91402280483261,1622
231,"ACC","ACC","T","T",93306,93320,85545,85558,178851,178878,1,1623
231,"ACC","ACT","T","T",3,93320,5,85558,8,178878,1.12835370898604,1624
231,"ACC","ATC","T","I",1,93320,3,85558,4,178878,1.57703131339084,1625
231,"ACC","GCC","T","A",2,93320,0,85558,2,178878,2.1476933637773,1626
232,"AGC","AAC","S","N",12,93361,12,85279,24,178640,0.606731270332324,1627
232,"AGC","AGA","S","R",10,93361,10,85279,20,178640,0.606731270332324,1628
232,"AGC","AGC","S","S",93318,93361,85243,85279,178561,178640,1,1629
232,"AGC","AGT","S","S",11,93361,2,85279,13,178640,2.6638060772085,1630
232,"AGC","ATC","S","I",7,93361,10,85279,17,178640,1.00248690408905,1631
232,"AGC","GGC","S","G",2,93361,2,85279,4,178640,0.606731270332324,1632
232,"AGC","TGC","S","C",1,93361,0,85279,1,178640,1.46734457416062,1633
233,"AAG","AAA","K","K",2,93147,1,86613,3,179760,1.08031220770703,1634
233,"AAG","AAC","K","N",1,93147,0,86613,1,179760,1.4948892590178,1635
233,"AAG","AAG","K","K",93135,93147,86606,86613,179741,179760,1,1636
233,"AAG","AAT","K","N",3,93147,4,86613,7,179760,0.886742732708965,1637
233,"AAG","ACG","K","T",4,93147,0,86613,4,179760,3.11873575584695,1638
233,"AAG","AGG","K","R",2,93147,0,86613,2,179760,2.17274928441978,1639
233,"AAG","ATG","K","M",0,93147,1,86613,1,179760,1.58200724567237,1640
233,"AAG","GAG","K","E",0,93147,1,86613,1,179760,1.58200724567237,1641
234,"TTT","CTT","F","L",2,94896,0,86996,2,181892,2.14759356988013,1642
234,"TTT","TTT","F","F",94894,94896,86996,86996,181890,181892,1,1643
235,"CCC","ACC","P","T",10,95702,11,87322,21,183024,0.704277786976091,1644
235,"CCC","CAC","P","H",2,95702,8,87322,10,183024,2.28567318134402,1645
235,"CCC","CCA","P","P",7,95702,11,87322,18,183024,1.1256770187468,1646
235,"CCC","CCC","P","P",95673,95702,87283,87322,182956,183024,1,1647
235,"CCC","CCG","P","P",1,95702,0,87322,1,183024,1.46538546497169,1648
235,"CCC","CCT","P","P",4,95702,3,87322,7,183024,0.833114889497224,1649
235,"CCC","CTC","P","L",5,95702,3,87322,8,183024,1.05524593813336,1650
235,"CCC","TCC","P","S",0,95702,3,87322,3,183024,2.82329983303926,1651
236,"AAC","AAA","N","K",3,96011,4,87971,7,183982,0.876303624809553,1652
236,"AAC","AAC","N","N",96005,96011,87964,87971,183969,183982,1,1653
236,"AAC","AAT","N","N",1,96011,1,87971,2,183982,0.6094962780662,1654
236,"AAC","AGC","N","S",0,96011,1,87971,1,183982,1.57681235321042,1655
236,"AAC","GAC","N","D",2,96011,1,87971,3,183982,1.06087070964833,1656
237,"ATG","ACG","M","T",0,97927,1,87374,1,185301,1.56778666376118,1657
237,"ATG","ATA","M","I",10,97927,13,87374,23,185301,0.882053651119619,1658
237,"ATG","ATC","M","I",1,97927,0,87374,1,185301,1.43128802292469,1659
237,"ATG","ATG","M","M",97912,97927,87357,87374,185269,185301,1,1660
237,"ATG","ATT","M","I",4,97927,3,87374,7,185301,0.808163357268404,1661
238,"TAC","AAC","Y","N",0,97135,4,86852,4,183987,3.25034941457341,1662
238,"TAC","CAC","Y","H",1,97135,4,86852,5,183987,1.95293584131862,1663
238,"TAC","TAA","Y",".",2,97135,4,86852,6,183987,1.27456102381107,1664
238,"TAC","TAC","Y","Y",97125,97135,86836,86852,183961,183987,1,1665
238,"TAC","TAG","Y",".",1,97135,0,86852,1,183987,1.43446815668281,1666
238,"TAC","TAT","Y","Y",3,97135,1,86852,4,183987,1.43446815668281,1667
238,"TAC","TGC","Y","C",3,97135,3,86852,6,183987,0.58742716271955,1668
239,"ATT","ACT","I","T",1,97990,1,85487,2,183477,0.565779311479321,1669
239,"ATT","ATC","I","I",1,97990,1,85487,2,183477,0.565779311479321,1671
239,"ATT","ATT","I","I",97987,97990,85469,85487,183456,183477,1,1672
239,"ATT","GTT","I","V",1,97990,2,85487,3,183477,1.10221229253599,1673
240,"CCA","ACA","P","T",11,98849,8,86857,19,185706,0.864074094963256,1674
240,"CCA","CAA","P","Q",3,98849,4,86857,7,185706,0.847885348385271,1675
240,"CCA","CCA","P","P",98821,98849,86839,86857,185660,185706,1,1676
240,"CCA","CCC","P","P",0,98849,1,86857,1,185706,1.56280836614333,1677
240,"CCA","CCG","P","P",10,98849,4,86857,14,185706,1.55550323379938,1678
240,"CCA","CGA","P","R",1,98849,0,86857,1,185706,1.40825597123927,1679
240,"CCA","CTA","P","L",1,98849,0,86857,1,185706,1.40825597123927,1680
240,"CCA","GCA","P","A",1,98849,0,86857,1,185706,1.40825597123927,1681
240,"CCA","TCA","P","S",1,98849,1,86857,2,185706,0.572224275209241,1682
241,"GTA","ATA","V","I",6,99064,2,86508,8,185572,1.63946312697886,1683
241,"GTA","GAA","V","E",1,99064,0,86508,1,185572,1.39890075441252,1684
241,"GTA","GCA","V","A",1,99064,0,86508,1,185572,1.39890075441252,1685
241,"GTA","GTA","V","V",99051,99064,86503,86508,185554,185572,1,1686
241,"GTA","GTG","V","V",2,99064,2,86508,4,185572,0.566838889175826,1687
241,"GTA","TTA","V","L",3,99064,1,86508,4,185572,1.39890075441252,1688
242,"GGA","AGA","G","R",1,98647,3,87137,4,185784,1.5645053402613,1689
242,"GGA","GAA","G","E",4,98647,1,87137,5,185784,1.77103549958557,1690
242,"GGA","GCA","G","A",4,98647,1,87137,5,185784,1.77103549958557,1691
242,"GGA","GGA","G","G",98620,98647,87116,87137,185736,185784,1,1692
242,"GGA","GGG","G","G",5,98647,5,87137,10,185784,0.576787351525164,1693
242,"GGA","GTA","G","V",8,98647,7,87137,15,185784,0.686917564073138,1694
242,"GGA","TGA","G",".",5,98647,4,87137,9,185784,0.7531344241616,1695
243,"CAG","AAG","Q","K",5,98854,2,88128,7,186982,1.43034559836012,1696
243,"CAG","CAA","Q","Q",4,98854,4,88128,8,186982,0.585025020777642,1697
243,"CAG","CAG","Q","Q",98788,98854,88084,88128,186872,186982,1,1698
243,"CAG","CAT","Q","H",15,98854,5,88128,20,186982,1.89515634970585,1699
243,"CAG","CCG","Q","P",3,98854,2,88128,5,186982,0.8810353617792,1700
243,"CAG","CGG","Q","R",19,98854,19,88128,38,186982,0.585025020777642,1701
243,"CAG","CTG","Q","L",10,98854,8,88128,18,186982,0.782826179715855,1702
243,"CAG","GAG","Q","E",1,98854,0,88128,1,186982,1.43034559836012,1703
243,"CAG","TAG","Q",".",9,98854,4,88128,13,186982,1.43034559836012,1704
244,"GTC","ATC","V","I",4,99380,3,87189,7,186569,0.789884653872421,1705
244,"GTC","GCC","V","A",8,99380,4,87189,12,186569,1.25128640683114,1706
244,"GTC","GTA","V","V",22,99380,7,87189,29,186569,1.99668782005696,1707
244,"GTC","GTC","V","V",99340,99380,87171,87189,186511,186569,1,1708
244,"GTC","GTG","V","V",1,99380,0,87189,1,186569,1.4061078355214,1709
244,"GTC","GTT","V","V",1,99380,2,87189,3,186569,1.1052604949918,1710
244,"GTC","TTC","V","F",4,99380,2,87189,6,186569,1.14387867145382,1711
245,"ACA","AAA","T","K",1,100010,4,87775,5,187785,1.94881324925749,1712
245,"ACA","ACA","T","T",99988,100010,87759,87775,187747,187785,1,1713
245,"ACA","ACG","T","T",9,100010,3,87775,12,187785,1.76038836407738,1714
245,"ACA","ACT","T","T",1,100010,1,87775,2,187785,0.571177960769776,1715
245,"ACA","ATA","T","I",11,100010,8,87775,19,187785,0.862684572931555,1716
246,"GAA","AAA","E","K",1,100275,4,87698,5,187973,1.94802662500114,1717
246,"GAA","CAA","E","Q",0,100275,2,87698,2,187973,2.27878725960482,1718
246,"GAA","GAA","E","E",100259,100275,87681,87698,187940,187973,1,1719
246,"GAA","GAC","E","D",1,100275,0,87698,1,187973,1.401016477817,1720
246,"GAA","TAA","E",".",14,100275,11,87698,25,187973,0.786204128312062,1721
247,"TAC","CAC","Y","H",0,100909,1,86775,1,187684,1.55592926709333,1722
247,"TAC","TAA","Y",".",4,100909,4,86775,8,187684,0.553591236914969,1723
247,"TAC","TAC","Y","Y",100781,100909,86665,86775,187446,187684,1,1724
247,"TAC","TAG","Y",".",2,100909,1,86775,3,187684,0.979772310875189,1725
247,"TAC","TAT","Y","Y",114,100909,103,86775,217,187684,0.644057664163878,1726
247,"TAC","TGC","Y","C",6,100909,1,86775,7,187684,2.30844160477612,1727
247,"TAC","TTC","Y","F",2,100909,0,86775,2,187684,2.035411094785,1728
248,"GGC","AGC","G","S",4,99962,3,88755,7,188717,0.803006572538984,1729
248,"GGC","CGC","G","R",0,99962,1,88755,1,188717,1.56624541017056,1730
248,"GGC","GAC","G","D",41,99962,26,88755,67,188717,1.06756942928163,1731
248,"GGC","GGA","G","G",13,99962,6,88755,19,188717,1.42420174927658,1732
248,"GGC","GGC","G","G",99884,99962,88702,88755,188586,188717,1,1733
248,"GGC","GGG","G","G",1,99962,0,88755,1,188717,1.42420174927658,1734
248,"GGC","GGT","G","G",3,99962,3,88755,6,188717,0.581452780651267,1735
248,"GGC","GTC","G","V",9,99962,8,88755,17,188717,0.679871195537926,1736
248,"GGC","TGC","G","C",7,99962,6,88755,13,188717,0.708062358149723,1737
249,"TTC","ATC","F","I",2,100812,0,87375,2,188187,2.04914984900484,1738
249,"TTC","CTC","F","L",1,100812,0,87375,1,188187,1.38754913176661,1739
249,"TTC","TCC","F","S",3,100812,1,87375,4,188187,1.38754913176661,1740
249,"TTC","TTA","F","L",3,100812,4,87375,7,188187,0.838871987150453,1741
249,"TTC","TTC","F","F",100802,100812,87370,87375,188172,188187,1,1742
249,"TTC","TTT","F","F",1,100812,0,87375,1,188187,1.38754913176661,1743
250,"CTA","ATA","L","I",1,101631,2,86126,3,187757,1.0879594159597,1744
250,"CTA","CAA","L","Q",3,101631,2,86126,5,187757,0.822779540932199,1745
250,"CTA","CCA","L","P",8,101631,6,86126,14,187757,0.782643566900164,1746
250,"CTA","CTA","L","L",101614,101631,86115,86126,187729,187757,1,1747
250,"CTA","CTG","L","L",2,101631,0,86126,2,187757,2.010077937337,1748
250,"CTA","TTA","L","L",3,101631,1,86126,4,187757,1.35398912558049,1749
251,"AAC","AAA","N","K",4,101680,6,85796,10,187476,0.982797616455202,1750
251,"AAC","AAC","N","N",101672,101680,85786,85796,187458,187476,1,1751
251,"AAC","AAT","N","N",2,101680,1,85796,3,187476,0.956211896444394,1752
251,"AAC","AGC","N","S",1,101680,0,85796,1,187476,1.34747120631696,1753
251,"AAC","CAC","N","H",0,101680,3,85796,3,187476,2.81612228544337,1754
251,"AAC","GAC","N","D",1,101680,0,85796,1,187476,1.34747120631696,1755
252,"CTA","ATA","L","I",12,101933,5,87804,17,189737,1.50041012429421,1756
252,"CTA","CCA","L","P",1,101933,0,87804,1,189737,1.37831581157334,1757
252,"CTA","CTA","L","L",101915,101933,87792,87804,189707,189737,1,1758
252,"CTA","CTC","L","L",0,101933,1,87804,1,189737,1.55647020533645,1759
252,"CTA","CTG","L","L",3,101933,6,87804,9,189737,1.33619855855791,1760
252,"CTA","CTT","L","L",1,101933,0,87804,1,189737,1.37831581157334,1761
252,"CTA","TTA","L","L",1,101933,0,87804,1,189737,1.37831581157334,1762
253,"GGT","AGT","G","S",1,102609,2,88822,3,191431,1.09835533471439,1763
253,"GGT","GAT","G","D",2,102609,3,88822,5,191431,0.927035604399886,1764
253,"GGT","GGA","G","G",0,102609,1,88822,1,191431,1.55798233902073,1765
253,"GGT","GGC","G","G",0,102609,1,88822,1,191431,1.55798233902073,1766
253,"GGT","GGT","G","G",102603,102609,88811,88822,191414,191431,1,1767
253,"GGT","GTT","G","V",1,102609,0,88822,1,191431,1.38552330109787,1768
253,"GGT","TGT","G","C",2,102609,4,88822,6,191431,1.26044964017911,1769
254,"GGC","AGC","G","S",3,103893,4,89011,7,192904,0.831504404412561,1770
254,"GGC","GAC","G","D",64,103893,50,89011,114,192904,0.785148394990998,1771
254,"GGC","GCC","G","A",0,103893,1,89011,1,192904,1.55482784268769,1772
254,"GGC","GGA","G","G",7,103893,7,89011,14,192904,0.550587391804541,1773
254,"GGC","GGC","G","G",103749,103893,88902,89011,192651,192904,1,1774
254,"GGC","GGT","G","G",59,103893,37,89011,96,192904,1.04048642704351,1775
254,"GGC","GTC","G","V",5,103893,6,89011,11,192904,0.73973612700072,1776
254,"GGC","TGC","G","C",6,103893,4,89011,10,192904,0.89165862699334,1777
255,"ACA","AAA","T","K",3,105253,5,89810,8,195063,1.0912869435625,1778
255,"ACA","ACA","T","T",105234,105253,89795,89810,195029,195063,1,1779
255,"ACA","ACC","T","T",1,105253,1,89810,2,195063,0.547025003933538,1780
255,"ACA","ACG","T","T",5,105253,3,89810,8,195063,0.970109975256426,1781
255,"ACA","ATA","T","I",6,105253,5,89810,11,195063,0.688652493412104,1782
255,"ACA","CCA","T","P",1,105253,0,89810,1,195063,1.36415535131934,1783
255,"ACA","GCA","T","A",3,105253,0,89810,3,195063,2.53763098181433,1784
255,"ACA","TCA","T","S",0,105253,1,89810,1,195063,1.5535243313671,1785
256,"CCC","ACC","P","T",2,106296,2,89550,4,195846,0.536199462486603,1786
256,"CCC","CAC","P","H",9,106296,8,89550,17,195846,0.629100713567904,1787
256,"CCC","CCA","P","P",4,106296,9,89550,13,195846,1.54958121255344,1788
256,"CCC","CCC","P","P",106269,106296,89512,89550,195781,195846,1,1789
256,"CCC","CCT","P","P",1,106296,2,89550,3,195846,1.08501948741099,1790
256,"CCC","CGC","P","R",2,106296,0,89550,2,195846,1.99951556116441,1791
256,"CCC","CTC","P","L",1,106296,4,89550,5,195846,1.94010727218831,1792
256,"CCC","TCC","P","S",8,106296,13,89550,21,195846,1.14079354378817,1793
257,"ACC","AAC","T","N",3,105323,5,89003,8,194326,1.08656175840031,1794
257,"ACC","ACA","T","T",3,105323,3,89003,6,194326,0.538867952345411,1795
257,"ACC","ACC","T","T",105312,105323,88991,89003,194303,194326,1,1796
257,"ACC","ACT","T","T",2,105323,1,89003,3,194326,0.958064743936301,1797
257,"ACC","ATC","T","I",3,105323,2,89003,5,194326,0.819537303630768,1798
257,"ACC","GCC","T","A",0,105323,1,89003,1,194326,1.55055066945499,1799
258,"AAG","AAA","K","K",1,104052,1,88375,2,192427,0.543103251886359,1800
258,"AAG","AAC","K","N",1,104052,0,88375,1,192427,1.35721598849483,1801
258,"AAG","AAG","K","K",104039,104052,88362,88375,192401,192427,1,1802
258,"AAG","AAT","K","N",11,104052,11,88375,22,192427,0.543103251886359,1803
258,"AAG","AGG","K","R",0,104052,1,88375,1,192427,1.55209272856369,1804
259,"AGA","AAA","R","K",1,105193,1,88308,2,193501,0.533467443887019,1805
259,"AGA","ACA","R","T",2,105193,0,88308,2,193501,1.9938157555059,1806
259,"AGA","AGA","R","R",105174,105193,88298,88308,193472,193501,1,1807
259,"AGA","ATA","R","I",16,105193,6,88308,22,193501,1.64037035965308,1808
259,"AGA","GGA","R","G",0,105193,1,88308,1,193501,1.54859038158322,1809
259,"AGA","TGA","R",".",0,105193,2,88308,2,193501,2.27262405894209,1810
260,"ATG","ACG","M","T",0,104787,1,88778,1,193565,1.55134213327639,1811
260,"ATG","ATA","M","I",3,104787,4,88778,7,193565,0.824306069890144,1812
260,"ATG","ATC","M","I",0,104787,1,88778,1,193565,1.55134213327639,1813
260,"ATG","ATG","M","M",104764,104787,88759,88778,193523,193565,1,1814
260,"ATG","ATT","M","I",13,104787,12,88778,25,193565,0.605667845916133,1815
260,"ATG","CTG","M","L",2,104787,0,88778,2,193565,2.00957962833997,1816
260,"ATG","GTG","M","V",3,104787,0,88778,3,193565,2.52450914753863,1817
260,"ATG","TTG","M","L",2,104787,1,88778,3,193565,0.96128136692363,1818
261,"CTT","ATT","L","I",10,104986,9,90214,19,195200,0.638361201518539,1819
261,"CTT","CAT","L","H",1,104986,1,90214,2,195200,0.552923063534184,1820
261,"CTT","CCT","L","P",1,104986,2,90214,3,195200,1.09471364498901,1821
261,"CTT","CTA","L","L",0,104986,1,90214,1,195200,1.55568408573327,1822
261,"CTT","CTC","L","L",2,104986,0,90214,2,195200,2.03404419337024,1823
261,"CTT","CTT","L","L",104951,104986,90180,90214,195131,195200,1,1824
261,"CTT","GTT","L","V",1,104986,0,90214,1,195200,1.37455253337578,1825
261,"CTT","TTT","L","F",20,104986,21,90214,41,195200,0.607498061147451,1826
262,"ATG","ACG","M","T",1,107242,0,91139,1,198381,1.35815401706565,1827
262,"ATG","AGG","M","R",1,107242,0,91139,1,198381,1.35815401706565,1828
262,"ATG","ATA","M","I",3,107242,3,91139,6,198381,0.543632683025121,1829
262,"ATG","ATC","M","I",1,107242,0,91139,1,198381,1.35815401706565,1830
262,"ATG","ATG","M","M",107228,107242,91128,91139,198356,198381,1,1831
262,"ATG","ATT","M","I",7,107242,6,91139,13,198381,0.664412994751211,1832
262,"ATG","GTG","M","V",1,107242,2,91139,3,198381,1.08931988350967,1833
263,"TAC","AAC","Y","N",0,107400,2,90265,2,197665,2.27276068997006,1834
263,"TAC","CAC","Y","H",2,107400,4,90265,6,197665,1.24816307257632,1835
263,"TAC","TAA","Y",".",4,107400,2,90265,6,197665,1.08571424136151,1836
263,"TAC","TAC","Y","Y",107385,107400,90239,90265,197624,197665,1,1837
263,"TAC","TAG","Y",".",1,107400,2,90265,3,197665,1.08389097934221,1838
263,"TAC","TAT","Y","Y",2,107400,12,90265,14,197665,2.96959039975648,1839
263,"TAC","TGC","Y","C",4,107400,4,90265,8,197665,0.534244972315996,1840
263,"TAC","TTC","Y","F",2,107400,0,90265,2,197665,1.99543963483557,1841
264,"AAC","AAA","N","K",4,106890,3,91820,7,198710,0.766828116704379,1842
264,"AAC","AAC","N","N",106882,106890,91811,91820,198693,198710,1,1843
264,"AAC","AAG","N","K",0,106890,1,91820,1,198710,1.55558830322825,1844
264,"AAC","AAT","N","N",0,106890,3,91820,3,198710,2.81767399673863,1845
264,"AAC","AGC","N","S",3,106890,1,91820,4,198710,1.37409324067062,1846
264,"AAC","GAC","N","D",0,106890,1,91820,1,198710,1.55558830322825,1847
264,"AAC","TAC","N","Y",1,106890,0,91820,1,198710,1.37409324067062,1848
265,"TTC","ATC","F","I",1,105721,1,86241,2,191962,0.50849088133448,1849
265,"TTC","CTC","F","L",3,105721,1,86241,4,191962,1.29503393507474,1850
265,"TTC","CTT","F","L",0,105721,1,86241,1,191962,1.53961182998032,1851
265,"TTC","TCC","F","S",2,105721,1,86241,3,191962,0.912786570906758,1853
265,"TTC","TTA","F","L",12,105721,6,86241,18,191962,1.189645025494,1854
265,"TTC","TTC","F","F",105703,105721,86054,86241,191757,191962,1,1855
265,"TTC","TTG","F","L",0,105721,1,86241,1,191962,1.53961182998032,1856
265,"TTC","TTT","F","F",0,105721,3,86241,3,191962,2.81317748766022,1857
266,"CCC","ACC","P","T",4,104913,3,92067,7,196980,0.789910108393906,1858
266,"CCC","CAC","P","H",11,104913,10,92067,21,196980,0.650458610462792,1859
266,"CCC","CCA","P","P",7,104913,2,92067,9,196980,1.86808596693996,1860
266,"CCC","CCC","P","P",104876,104913,92031,92067,196907,196980,1,1861
266,"CCC","CCG","P","P",2,104913,0,92067,2,196980,2.07070632571364,1862
266,"CCC","CCT","P","P",4,104913,1,92067,5,196980,1.76006125966166,1863
266,"CCC","CGC","P","R",2,104913,1,92067,3,196980,1.00525560468438,1864
266,"CCC","GCC","P","A",1,104913,2,92067,3,196980,1.10527237951795,1866
266,"CCC","TCC","P","S",6,104913,9,92067,15,196980,1.0334916540471,1867
267,"ACA","AAA","T","K",9,103903,7,91379,16,195282,0.792280536464956,1868
267,"ACA","ACA","T","T",103887,103903,91361,91379,195248,195282,1,1869
267,"ACA","ACC","T","T",0,103903,5,91379,5,195282,3.6047745764839,1870
267,"ACA","ACG","T","T",1,103903,1,91379,2,195282,0.572894849760887,1871
267,"ACA","ACT","T","T",0,103903,1,91379,1,195282,1.5630574430121,1872
267,"ACA","AGA","T","R",1,103903,0,91379,1,195282,1.4094182660931,1873
267,"ACA","ATA","T","I",5,103903,2,91379,7,195282,1.4094182660931,1874
267,"ACA","CCA","T","P",0,103903,1,91379,1,195282,1.5630574430121,1875
267,"ACA","GCA","T","A",0,103903,1,91379,1,195282,1.5630574430121,1876
268,"AGA","AAA","R","K",4,103940,2,92247,6,196187,1.15934162624157,1877
268,"AGA","ACA","R","T",0,103940,1,92247,1,196187,1.5660334544785,1878
268,"AGA","AGA","R","R",103918,103940,92225,92247,196143,196187,1,1879
268,"AGA","AGG","R","R",1,103940,1,92247,2,196187,0.580885219968541,1880
268,"AGA","ATA","R","I",17,103940,12,92247,29,196187,0.920280240846015,1881
268,"AGA","CGA","R","R",0,103940,3,92247,3,196187,2.82064171998444,1882
268,"AGA","GGA","R","G",0,103940,3,92247,3,196187,2.82064171998444,1883
269,"GCA","ACA","A","T",11,104930,12,93114,23,198044,0.673538877765454,1884
269,"GCA","CCA","A","P",1,104930,1,93114,2,198044,0.580848354886319,1885
269,"GCA","GAA","A","E",15,104930,9,93114,24,198044,1.10397751217071,1886
269,"GCA","GCA","A","A",104861,104930,93058,93114,197919,198044,1,1887
269,"GCA","GCC","A","A",0,104930,1,93114,1,198044,1.56601968981026,1888
269,"GCA","GCG","A","A",17,104930,17,93114,34,198044,0.580848354886319,1889
269,"GCA","GCT","A","A",1,104930,0,93114,1,198044,1.42316063945109,1890
269,"GCA","GGA","A","G",1,104930,1,93114,2,198044,0.580848354886319,1891
269,"GCA","GTA","A","V",14,104930,9,93114,23,198044,1.0195680362926,1892
269,"GCA","TCA","A","S",9,104930,6,93114,15,198044,0.958297409971561,1893
270,"GGC","AGC","G","S",4,105010,1,93753,5,198763,1.78868482961474,1894
270,"GGC","GAC","G","D",12,105010,14,93753,26,198763,0.755377019540263,1895
270,"GGC","GGA","G","G",14,105010,17,93753,31,198763,0.805159320565874,1896
270,"GGC","GGC","G","G",104931,105010,93680,93753,198611,198763,1,1897
270,"GGC","GGG","G","G",0,105010,1,93753,1,198763,1.56800174579885,1898
270,"GGC","GGT","G","G",29,105010,28,93753,57,198763,0.616789642386021,1899
270,"GGC","GTC","G","V",17,105010,11,93753,28,198763,1.02724838624364,1900
270,"GGC","TGC","G","C",3,105010,1,93753,4,198763,1.43227379694828,1901
271,"CAG","AAG","Q","K",6,105565,1,94194,7,199759,2.3754035630016,1902
271,"CAG","CAA","Q","Q",13,105565,6,94194,19,199759,1.43160737117373,1903
271,"CAG","CAG","Q","Q",105535,105565,94178,94194,199713,199759,1,1904
271,"CAG","CAT","Q","H",5,105565,3,94194,8,199759,1.02668636601921,1905
271,"CAG","CGG","Q","R",2,105565,2,94194,4,199759,0.585759794628359,1906
271,"CAG","TAG","Q",".",4,105565,4,94194,8,199759,0.585759794628359,1907
272,"TGT","CGT","C","R",0,107074,2,94834,2,201908,2.28079280526692,1908
272,"TGT","GGT","C","G",1,107074,0,94834,1,201908,1.42014924873512,1909
272,"TGT","TAT","C","Y",5,107074,2,94834,7,201908,1.42014924873512,1910
272,"TGT","TGC","C","C",1,107074,1,94834,2,201908,0.579101550795033,1911
272,"TGT","TGT","C","C",107061,107074,94822,94834,201883,201908,1,1912
272,"TGT","TTT","C","F",6,107074,7,94834,13,201908,0.737430506822986,1913
273,"GGT","AGT","G","S",7,106328,2,96117,9,202445,1.91838954621328,1914
273,"GGT","GAT","G","D",7,106328,12,96117,19,202445,1.24059026225039,1915
273,"GGT","GCT","G","A",1,106328,1,96117,2,202445,0.597202631361005,1916
273,"GGT","GGA","G","G",0,106328,1,96117,1,202445,1.57215730335073,1917
273,"GGT","GGC","G","G",1,106328,3,96117,4,202445,1.57215730335073,1918
273,"GGT","GGT","G","G",106301,106328,96085,96117,202386,202445,1,1919
273,"GGT","GTT","G","V",4,106328,4,96117,8,202445,0.597202631361005,1920
273,"GGT","TGT","G","C",7,106328,9,96117,16,202445,0.866902478604262,1921
274,"GGA","AGA","G","R",9,106308,3,97126,12,203434,1.82719734875258,1922
274,"GGA","CGA","G","R",2,106308,0,97126,2,203434,2.14143853669768,1923
274,"GGA","GAA","G","E",1,106308,1,97126,2,203434,0.606843018910937,1924
274,"GGA","GCA","G","A",1,106308,1,97126,2,203434,0.606843018910937,1925
274,"GGA","GGA","G","G",106272,106308,97088,97126,203360,203434,1,1926
274,"GGA","GGG","G","G",7,106308,14,97126,21,203434,1.4702345453026,1927
274,"GGA","GTA","G","V",9,106308,13,97126,22,203434,1.02769984504275,1928
274,"GGA","TGA","G",".",7,106308,6,97126,13,203434,0.737225997619038,1929
275,"GTG","ATG","V","M",3,105985,2,98317,5,204302,0.927994733739365,1930
275,"GTG","CTG","V","L",0,105985,1,98317,1,204302,1.58110128493421,1931
275,"GTG","GAG","V","E",1,105985,0,98317,1,204302,1.49092951527833,1932
275,"GTG","GCG","V","A",0,105985,1,98317,1,204302,1.58110128493421,1933
275,"GTG","GTA","V","V",12,105985,18,98317,30,204302,1.09741160836668,1934
275,"GTG","GTC","V","V",0,105985,1,98317,1,204302,1.58110128493421,1935
275,"GTG","GTG","V","V",105955,105985,98276,98317,204231,204302,1,1936
275,"GTG","GTT","V","V",8,105985,14,98317,22,204302,1.29145695611296,1937
275,"GTG","TTG","V","L",6,105985,4,98317,10,204302,0.988127062008681,1938
276,"CTC","ATC","L","I",9,102814,11,99209,20,202023,0.863420480657538,1939
276,"CTC","CAC","L","H",1,102814,4,99209,5,202023,1.97147453193318,1940
276,"CTC","CCC","L","P",2,102814,4,99209,6,202023,1.31077185813379,1941
276,"CTC","CGC","L","R",1,102814,0,99209,1,202023,1.55287406170408,1942
276,"CTC","CTA","L","L",13,102814,8,99209,21,202023,1.17970479683843,1943
276,"CTC","CTC","L","L",102763,102814,99168,99209,201931,202023,1,1944
276,"CTC","CTG","L","L",2,102814,1,99209,3,202023,1.12989445227067,1945
276,"CTC","CTT","L","L",4,102814,4,99209,8,202023,0.658171437860954,1946
276,"CTC","GTC","L","V",1,102814,0,99209,1,202023,1.55287406170408,1947
276,"CTC","TTC","L","F",18,102814,9,99209,27,202023,1.47289403743302,1948
277,"ATG","AAG","M","K",0,100455,1,101386,1,201841,1.59465564820398,1949
277,"ATG","ACG","M","T",3,100455,2,101386,5,201841,1.01502625633833,1950
277,"ATG","ATA","M","I",1,100455,3,101386,4,201841,1.59465564820398,1951
277,"ATG","ATC","M","I",1,100455,0,101386,1,201841,1.60576278167224,1952
277,"ATG","ATG","M","M",100439,100455,101373,101386,201812,201841,1,1953
277,"ATG","ATT","M","I",6,100455,1,101386,7,201841,2.58261229690517,1954
277,"ATG","GTG","M","V",5,100455,5,101386,10,201841,0.683933904036423,1955
277,"ATG","TTG","M","L",0,100455,1,101386,1,201841,1.59465564820398,1956
278,"TCC","CCC","S","P",5,98925,8,102071,13,200996,1.13567727157808,1957
278,"TCC","TAC","S","Y",5,98925,4,102071,9,200996,0.866779496119561,1958
278,"TCC","TCA","S","S",6,98925,3,102071,9,200996,1.38672830762082,1959
278,"TCC","TCC","S","S",98898,98925,102047,102071,200945,200996,1,1960
278,"TCC","TCG","S","S",1,98925,0,102071,1,200996,1.59721069630466,1961
278,"TCC","TCT","S","S",3,98925,6,102071,9,200996,1.35490966060151,1962
278,"TCC","TTC","S","F",7,98925,3,102071,10,200996,1.59721069630466,1963
279,"ACC","AAC","T","N",2,96702,4,102265,6,198967,1.24796634149959,1964
279,"ACC","ACA","T","T",2,96702,6,102265,8,198967,1.76937307480101,1965
279,"ACC","ACC","T","T",96666,96702,102238,102265,198904,198967,1,1966
279,"ACC","ACG","T","T",1,96702,1,102265,2,198967,0.638675536167599,1967
279,"ACC","ACT","T","T",19,96702,4,102265,23,198967,2.82695679624147,1968
279,"ACC","AGC","T","S",1,96702,1,102265,2,198967,0.638675536167599,1969
279,"ACC","ATC","T","I",10,96702,10,102265,20,198967,0.638675536167599,1970
279,"ACC","GCC","T","A",1,96702,0,102265,1,198967,1.58800398250257,1971
279,"ACC","TCC","T","S",0,96702,1,102265,1,198967,1.52079966078228,1972
280,"GGC","AGC","G","S",8,96056,11,102117,19,198173,0.945345506310577,1973
280,"GGC","CGC","G","R",1,96056,0,102117,1,198173,1.58621178841514,1974
280,"GGC","GAC","G","D",34,96056,54,102117,88,198173,1.15874137915042,1975
280,"GGC","GCC","G","A",1,96056,0,102117,1,198173,1.58621178841514,1976
280,"GGC","GGA","G","G",12,96056,14,102117,26,198173,0.778650736735364,1977
280,"GGC","GGC","G","G",95985,96056,102019,102117,198004,198173,1,1978
280,"GGC","GGT","G","G",1,96056,4,102117,5,198173,1.87679701955184,1979
280,"GGC","GTC","G","V",13,96056,12,102117,25,198173,0.715383581466217,1980
280,"GGC","TGC","G","C",1,96056,3,102117,4,198173,1.51310993028178,1981
281,"AAG","AAG","K","K",94889,94903,101967,101979,196856,196882,1,1982
281,"AAG","AAT","K","N",10,94903,6,101979,16,196882,1.20458607076133,1983
281,"AAG","AGG","K","R",2,94903,3,101979,5,196882,0.931982385880581,1984
281,"AAG","ATG","K","M",1,94903,2,101979,3,196882,1.08128926099953,1985
281,"AAG","CAG","K","Q",1,94903,0,101979,1,196882,1.5822702769605,1986
281,"AAG","GAG","K","E",0,94903,1,101979,1,196882,1.49603664675992,1987
282,"GTA","ATA","V","I",4,93614,6,104391,10,198005,0.946248642488769,1988
282,"GTA","GAA","V","E",1,93614,1,104391,2,198005,0.590059564366808,1989
282,"GTA","GCA","V","A",4,93614,1,104391,5,198005,1.95360842287912,1990
282,"GTA","GTA","V","V",93598,93614,104379,104391,197977,198005,1,1991
282,"GTA","GTC","V","V",3,93614,0,104391,3,198005,2.82162265860066,1992
282,"GTA","GTG","V","V",2,93614,2,104391,4,198005,0.590059564366808,1993
282,"GTA","TTA","V","L",2,93614,2,104391,4,198005,0.590059564366808,1994
283,"CTG","ATG","L","M",4,92591,7,105468,11,198059,1.08956146608476,1995
283,"CTG","CAG","L","Q",1,92591,0,105468,1,198059,1.56249124644478,1996
283,"CTG","CCG","L","P",9,92591,3,105468,12,198059,1.94886170624658,1997
283,"CTG","CTA","L","L",5,92591,4,105468,9,198059,0.793305326904073,1998
283,"CTG","CTG","L","L",92562,92591,105437,105468,197999,198059,1,1999
283,"CTG","CTT","L","L",3,92591,10,105468,13,198059,1.92108363038842,2000
283,"CTG","TTG","L","L",7,92591,7,105468,14,198059,0.571370103796494,2001
284,"GGT","AGT","G","S",2,91140,5,105560,7,196700,1.3818987902938,2002
284,"GGT","CGT","G","R",3,91140,1,105560,4,196700,1.55722083897958,2003
284,"GGT","GAT","G","D",5,91140,17,105560,22,196700,2.04258649652715,2004
284,"GGT","GCT","G","A",1,91140,1,105560,2,196700,0.557106399513053,2005
284,"GGT","GGA","G","G",0,91140,1,105560,1,196700,1.3818987902938,2006
284,"GGT","GGC","G","G",2,91140,2,105560,4,196700,0.557106399513053,2007
284,"GGT","GGT","G","G",91117,91140,105522,105560,196639,196700,1,2008
284,"GGT","GTT","G","V",0,91140,2,105560,2,196700,2.04258649652715,2009
284,"GGT","TGT","G","C",10,91140,9,105560,19,196700,0.670704249260568,2010
285,"ATC","ACC","I","T",1,92451,1,106086,2,198537,0.564954009059293,2011
285,"ATC","AGC","I","S",0,92451,1,106086,1,198537,1.3956176299889,2012
285,"ATC","ATA","I","I",4,92451,6,106086,10,198537,0.91162348006365,2013
285,"ATC","ATC","I","I",92438,92451,106078,106086,198516,198537,1,2014
285,"ATC","ATT","I","I",5,92451,0,106086,5,198537,3.60439307388769,2015
285,"ATC","CTC","I","L",2,92451,0,106086,2,198537,2.27822752802615,2016
285,"ATC","GTC","I","V",1,92451,0,106086,1,198537,1.56011464803601,2017
286,"CAT","AAT","H","N",1,90481,6,106398,7,196879,2.28842994249039,2018
286,"CAT","CAG","H","Q",1,90481,0,106398,1,196879,1.55249078121168,2019
286,"CAT","CAT","H","H",90473,90481,106386,106398,196859,196879,1,2020
286,"CAT","CGT","H","R",3,90481,1,106398,4,196879,1.55249078121168,2021
286,"CAT","CTT","H","L",0,90481,1,106398,1,196879,1.35914929610464,2022
286,"CAT","GAT","H","D",1,90481,0,106398,1,196879,1.55249078121168,2023
286,"CAT","TAT","H","Y",2,90481,4,106398,6,196879,1.10158938152446,2024
287,"GTT","ATT","V","I",2,90431,3,107124,5,197555,0.818394940372259,2025
287,"GTT","GCT","V","A",1,90431,1,107124,2,197555,0.538017291247931,2026
287,"GTT","GTC","V","V",1,90431,1,107124,2,197555,0.538017291247931,2027
287,"GTT","GTG","V","V",1,90431,0,107124,1,197555,1.55024144716648,2028
287,"GTT","GTT","V","V",90423,90431,107116,107124,197539,197555,1,2029
287,"GTT","TTT","V","F",3,90431,3,107124,6,197555,0.538017291247931,2030
288,"GGT","AGT","G","S",2,88365,3,107757,5,196122,0.786475433144503,2031
288,"GGT","CGT","G","R",1,88365,0,107757,1,196122,1.54170491709821,2032
288,"GGT","GAT","G","D",2,88365,5,107757,7,196122,1.30568043375846,2033
288,"GGT","GCT","G","A",0,88365,1,107757,1,196122,1.30568043375846,2034
288,"GGT","GGA","G","G",0,88365,1,107757,1,196122,1.30568043375846,2035
288,"GGT","GGC","G","G",4,88365,2,107757,6,196122,1.23846917485782,2036
288,"GGT","GGT","G","G",88354,88365,107737,107757,196091,196122,1,2037
288,"GGT","GTT","G","V",1,88365,6,107757,7,196122,2.22340496888641,2038
288,"GGT","TGT","G","C",1,88365,2,107757,3,196122,0.921571578167505,2039
289,"GGA","AAA","G","K",0,88296,1,107727,1,196023,1.30487415266192,2040
289,"GGA","AGA","G","R",5,88296,3,107727,8,196023,1.07220200697643,2041
289,"GGA","GAA","G","E",1,88296,4,107727,5,196023,1.6484257370075,2042
289,"GGA","GCA","G","A",1,88296,2,107727,3,196023,0.920905699845185,2043
289,"GGA","GGA","G","G",88274,88296,107699,107727,195973,196023,1,2044
289,"GGA","GGG","G","G",1,88296,0,107727,1,196023,1.54154577618629,2045
289,"GGA","GTA","G","V",5,88296,13,107727,18,196023,1.53850283951961,2046
289,"GGA","TGA","G",".",9,88296,5,107727,14,196023,1.23825365480039,2047
290,"AAT","AAA","N","K",1,77004,2,106190,3,183194,0.776182579547097,2048
290,"AAT","AAC","N","N",0,77004,1,106190,1,183194,1.12675220251508,2049
290,"AAT","AAT","N","N",76672,77004,106182,106190,182854,183194,1,2050
290,"AAT","ACT","N","T",3,77004,2,106190,5,183194,0.832553609200157,2051
290,"AAT","AGT","N","S",0,77004,1,106190,1,183194,1.12675220251508,2052
290,"AAT","GAT","N","D",0,77004,1,106190,1,183194,1.12675220251508,2054
290,"AAT","TAT","N","Y",0,77004,1,106190,1,183194,1.12675220251508,2055
291,"GGC","AGC","G","S",2,85986,1,106483,3,192469,1.06547141782753,2056
291,"GGC","CGC","G","R",0,85986,1,106483,1,192469,1.28338285935111,2057
291,"GGC","GAC","G","D",28,85986,58,106483,86,192469,1.30821452308048,2058
291,"GGC","GCC","G","A",0,85986,1,106483,1,192469,1.28338285935111,2059
291,"GGC","GGA","G","G",10,85986,8,106483,18,192469,0.763621475466994,2060
291,"GGC","GGC","G","G",85893,85986,106357,106483,192250,192469,1,2061
291,"GGC","GGG","G","G",0,85986,1,106483,1,192469,1.28338285935111,2062
291,"GGC","GGT","G","G",39,85986,35,106483,74,192469,0.634868871283681,2063
291,"GGC","GTC","G","V",7,85986,17,106483,24,192469,1.45903284101351,2064
291,"GGC","TGC","G","C",7,85986,4,106483,11,192469,1.16695818182485,2065
292,"CAT","AAT","H","N",5,84614,5,106343,10,190957,0.490467293498487,2066
292,"CAT","CAC","H","H",1,84614,2,106343,3,190957,0.885595673963663,2067
292,"CAT","CAT","H","H",84605,84614,106333,106343,190938,190957,1,2068
292,"CAT","CTT","H","L",0,84614,1,106343,1,190957,1.26195393779292,2069
292,"CAT","TAT","H","Y",3,84614,2,106343,5,190957,0.879982263858009,2070
293,"CAG","AAG","Q","K",7,84038,8,105182,15,189220,0.59223940430306,2071
293,"CAG","CAA","Q","Q",1,84038,2,105182,3,189220,0.890563715442606,2072
293,"CAG","CAG","Q","Q",84008,84038,105138,105182,189146,189220,1,2073
293,"CAG","CAT","Q","H",10,84038,9,105182,19,189220,0.614345107795861,2074
293,"CAG","CGG","Q","R",9,84038,20,105182,29,189220,1.33908361823723,2075
293,"CAG","GAG","Q","E",0,84038,1,105182,1,189220,1.26801258034261,2076
293,"CAG","TAG","Q",".",3,84038,4,105182,7,189220,0.691932122698095,2077
294,"GGC","AGC","G","S",2,83502,3,104847,5,188349,0.754917190966689,2078
294,"GGC","CGC","G","R",0,83502,1,104847,1,188349,1.26320243760531,2079
294,"GGC","GAC","G","D",16,83502,19,104847,35,188349,0.630080153257613,2080
294,"GGC","GGA","G","G",31,83502,32,104847,63,188349,0.515477645868135,2081
294,"GGC","GGC","G","G",83430,83502,104765,104847,188195,188349,1,2082
294,"GGC","GGG","G","G",1,83502,0,104847,1,188349,1.5334597825238,2083
294,"GGC","GGT","G","G",3,83502,6,104847,9,188349,1.07915200768176,2084
294,"GGC","GTC","G","V",11,83502,12,104847,23,188349,0.556343863654239,2085
294,"GGC","TGC","G","C",8,83502,9,104847,17,188349,0.578264366908374,2086
295,"TTC","ATC","F","I",1,82469,0,106889,1,189358,1.52504258113102,2087
295,"TTC","CTC","F","L",0,82469,2,106889,2,189358,1.84972222340788,2088
295,"TTC","GTC","F","V",1,82469,0,106889,1,189358,1.52504258113102,2089
295,"TTC","TAC","F","Y",0,82469,1,106889,1,189358,1.21827709624564,2090
295,"TTC","TCC","F","S",2,82469,1,106889,3,189358,1.04568230120184,2091
295,"TTC","TGC","F","C",0,82469,1,106889,1,189358,1.21827709624564,2092
295,"TTC","TTA","F","L",6,82469,13,106889,19,189358,1.21827709624564,2093
295,"TTC","TTC","F","F",82458,82469,106869,106889,189327,189358,1,2094
295,"TTC","TTT","F","F",1,82469,2,106889,3,189358,0.849942911896474,2095
296,"TCA","CCA","S","P",3,84008,5,107795,8,191803,0.861410702601228,2096
296,"TCA","TAA","S",".",15,84008,9,107795,24,191803,1.15288955990318,2097
296,"TCA","TCA","S","S",83985,84008,107768,107795,191753,191803,1,2098
296,"TCA","TCG","S","S",2,84008,8,107795,10,191803,1.86655567694505,2099
296,"TCA","TGA","S",".",0,84008,1,107795,1,191803,1.23236420085334,2100
296,"TCA","TTA","S","L",3,84008,4,107795,7,191803,0.667293888485771,2101
297,"GCA","ACA","A","T",4,85538,5,105712,9,191250,0.664089462011567,2102
297,"GCA","CCA","A","P",0,85538,2,105712,2,191250,1.93036203931342,2103
297,"GCA","GAA","A","E",9,85538,11,105712,20,191250,0.664089462011567,2104
297,"GCA","GCA","A","A",85499,85538,105670,105712,191169,191250,1,2105
297,"GCA","GCG","A","A",0,85538,1,105712,1,191250,1.28610624387483,2106
297,"GCA","GTA","A","V",22,85538,17,105712,39,191250,0.827408486441662,2107
297,"GCA","TCA","A","S",4,85538,6,105712,10,191250,0.825555082188117,2108
298,"GCA","ACA","A","T",22,84350,47,107560,69,191910,1.30289028770237,2109
298,"GCA","CCA","A","P",0,84350,2,107560,2,191910,1.87760039984031,2110
298,"GCA","GAA","A","E",13,84350,19,107560,32,191910,0.813476523007118,2111
298,"GCA","GCA","A","A",84298,84350,107466,107560,191764,191910,1,2112
298,"GCA","GCT","A","A",0,84350,1,107560,1,191910,1.24162792380757,2113
298,"GCA","GTA","A","V",13,84350,14,107560,27,191910,0.534357627092017,2114
298,"GCA","TCA","A","S",4,84350,11,107560,15,191910,1.51384964160897,2115
299,"CTC","ATC","L","I",2,84525,1,107953,3,192478,1.0518404388178,2116
299,"CTC","CAC","L","H",2,84525,4,107953,6,192478,0.994192989205565,2117
299,"CTC","CCC","L","P",5,84525,5,107953,10,192478,0.478043282462455,2118
299,"CTC","CTA","L","L",12,84525,9,107953,21,192478,0.834175838928257,2119
299,"CTC","CTC","L","L",84497,84525,107930,107953,192427,192478,1,2120
299,"CTC","CTT","L","L",5,84525,1,107953,6,192478,2.26310753731267,2121
299,"CTC","TTC","L","F",2,84525,3,107953,5,192478,0.736985670750792,2122
300,"CTC","ATC","L","I",7,84900,14,108819,21,193719,1.14440188918924,2123
300,"CTC","CAA","L","Q",0,84900,1,108819,1,193719,1.23415791138096,2124
300,"CTC","CAC","L","H",2,84900,0,108819,2,193719,2.26268674261762,2125
300,"CTC","CCC","L","P",6,84900,13,108819,19,193719,1.23415791138096,2126
300,"CTC","CGC","L","R",1,84900,1,108819,2,193719,0.475532740505939,2127
300,"CTC","CTA","L","L",7,84900,12,108819,19,193719,0.958507029033363,2128
300,"CTC","CTC","L","L",84874,84900,108771,108819,193645,193719,1,2129
300,"CTC","CTG","L","L",0,84900,1,108819,1,193719,1.23415791138096,2130
300,"CTC","CTT","L","L",1,84900,3,108819,4,193719,1.23415791138096,2131
300,"CTC","TTC","L","F",2,84900,3,108819,5,193719,0.733539070874407,2132
301,"AAA","AAA","K","K",85243,85244,107067,107072,192310,192316,1,2133
301,"AAA","AAG","K","K",0,85244,1,107072,1,192316,1.262862388791,2134
301,"AAA","ACA","K","T",0,85244,1,107072,1,192316,1.262862388791,2135
301,"AAA","AGA","K","R",0,85244,1,107072,1,192316,1.262862388791,2136
301,"AAA","GAA","K","E",1,85244,2,107072,3,192316,0.886340251517816,2137
302,"CAC","AAC","H","N",2,85291,6,106426,8,191717,1.50345371563399,2138
302,"CAC","CAA","H","Q",3,85291,5,106426,8,191717,0.894155168831359,2139
302,"CAC","CAC","H","H",85281,85291,106407,106426,191688,191717,1,2140
302,"CAC","CAT","H","H",4,85291,4,106426,8,191717,0.49612315746525,2141
302,"CAC","GAC","H","D",0,85291,4,106426,4,191717,2.83665126881846,2142
302,"CAC","TAC","H","Y",1,85291,0,106426,1,191717,1.53521893978558,2143
303,"TAC","AAC","Y","N",0,86517,1,105378,1,191895,1.30724579179568,2144
303,"TAC","CAC","Y","H",6,86517,2,105378,8,191895,1.81130707871334,2145
303,"TAC","TAA","Y",".",3,86517,5,105378,8,191895,0.922864617447256,2146
303,"TAC","TAC","Y","Y",86504,86517,105368,105378,191872,191895,1,2147
303,"TAC","TAT","Y","Y",2,86517,1,105378,3,191895,1.07295084747443,2148
303,"TAC","TGC","Y","C",2,86517,1,105378,3,191895,1.07295084747443,2149
304,"TTC","ATC","F","I",3,87074,1,102832,4,189906,1.55117133596465,2150
304,"TTC","CTC","F","L",2,87074,1,102832,3,189906,1.08754868894881,2151
304,"TTC","TAC","F","Y",0,87074,1,102832,1,189906,1.35272943945936,2152
304,"TTC","TCC","F","S",1,87074,1,102832,2,189906,0.54057399859597,2153
304,"TTC","TGC","F","C",0,87074,1,102832,1,189906,1.35272943945936,2154
304,"TTC","TTA","F","L",10,87074,12,102832,22,189906,0.693856309430264,2155
304,"TTC","TTC","F","F",87058,87074,102814,102832,189872,189906,1,2156
304,"TTC","TTT","F","F",0,87074,1,102832,1,189906,1.35272943945936,2157
305,"AAT","AAC","N","N",0,88720,1,101027,1,189747,1.40721536480146,2158
305,"AAT","AAT","N","N",88712,88720,101022,101027,189734,189747,1,2159
305,"AAT","AGT","N","S",6,88720,4,101027,10,189747,1.00471961048204,2160
305,"AAT","GAT","N","D",2,88720,0,101027,2,189747,2.27943328441453,2161
306,"GAT","AAT","D","N",1,89218,2,99432,3,188650,1.03372853965955,2162
306,"GAT","CAT","D","H",2,89218,0,99432,2,188650,2.28290511588614,2163
306,"GAT","GAA","D","E",1,89218,0,99432,1,188650,1.56968286835248,2164
306,"GAT","GAC","D","D",1,89218,1,99432,2,188650,0.590629340223377,2165
306,"GAT","GAT","D","D",89201,89218,99412,99432,188613,188650,1,2166
306,"GAT","GGT","D","G",9,89218,5,99432,14,188650,1.27617305111412,2167
306,"GAT","TAT","D","Y",3,89218,12,99432,15,188650,2.25172573134093,2168
307,"GAG","AAG","E","K",3,89770,4,98555,7,188325,0.83129124708268,2169
307,"GAG","GAA","E","E",7,89770,9,98555,16,188325,0.83129124708268,2170
307,"GAG","GAC","E","D",0,89770,1,98555,1,188325,1.46290387029359,2171
307,"GAG","GAG","E","E",89729,89770,98513,98555,188242,188325,1,2172
307,"GAG","GAT","E","D",13,89770,9,98555,22,188325,1.02590553360343,2173
307,"GAG","GGG","E","G",7,89770,5,98555,12,188325,0.958352862060859,2174
307,"GAG","GTG","E","V",0,89770,1,98555,1,188325,1.46290387029359,2175
307,"GAG","TAC","E","Y",0,89770,1,98555,1,188325,1.46290387029359,2176
307,"GAG","TAG","E",".",11,89770,12,98555,23,188325,0.679885498782719,2177
308,"CAA","AAA","Q","K",12,89479,12,96792,24,186271,0.617590557949972,2178
308,"CAA","CAA","Q","Q",89450,89479,96769,96792,186219,186271,1,2179
308,"CAA","CAC","Q","H",3,89479,1,96792,4,186271,1.57989672757041,2180
308,"CAA","CAG","Q","Q",3,89479,2,96792,5,186271,0.967832243545475,2181
308,"CAA","CAT","Q","H",0,89479,1,96792,1,186271,1.48564586742868,2182
308,"CAA","CGA","Q","R",0,89479,1,96792,1,186271,1.48564586742868,2183
308,"CAA","CTA","Q","L",1,89479,1,96792,2,186271,0.617590557949972,2184
308,"CAA","GAA","Q","E",1,89479,0,96792,1,186271,1.57989672757041,2185
308,"CAA","TAA","Q",".",9,89479,5,96792,14,186271,1.28984739917447,2186
309,"GGT","AGT","G","S",1,90553,2,97237,3,187790,1.08223230095606,2187
309,"GGT","GAT","G","D",2,90553,4,97237,6,187790,1.22640823885659,2188
309,"GGT","GGA","G","G",0,90553,1,97237,1,187790,1.49714390622252,2189
309,"GGT","GGC","G","G",1,90553,0,97237,1,187790,1.58252432971726,2190
309,"GGT","GGT","G","G",90537,90553,97221,97237,187758,187790,1,2191
309,"GGT","GTT","G","V",2,90553,3,97237,5,187790,0.932847523346437,2192
309,"GGT","TGT","G","C",10,90553,6,97237,16,187790,1.2049566872744,2193
310,"GAA","AAA","E","K",3,90974,2,95281,5,186255,0.989281314939333,2194
310,"GAA","GAA","E","E",90953,90974,95265,95281,186218,186255,1,2195
310,"GAA","GGA","E","G",1,90974,0,95281,1,186255,1.59158412575497,2196
310,"GAA","GTA","E","V",1,90974,0,95281,1,186255,1.59158412575497,2197
310,"GAA","TAA","E",".",16,90974,14,95281,30,186255,0.786622807629071,2198
311,"ATA","ACA","I","T",0,91199,3,93740,3,184939,2.78150476917696,2199
311,"ATA","AGA","I","R",1,91199,0,93740,1,184939,1.59867134303122,2200
311,"ATA","ATA","I","I",91190,91199,93734,93740,184924,184939,1,2201
311,"ATA","ATG","I","M",5,91199,2,93740,7,184939,1.59867134303122,2202
311,"ATA","ATT","I","I",2,91199,0,93740,2,184939,2.29721629809971,2203
311,"ATA","GTA","I","V",1,91199,1,93740,2,184939,0.666010238584533,2204
312,"GAA","AAA","E","K",0,93967,1,91683,1,185650,1.59979016353682,2205
312,"GAA","GAA","E","E",93955,93967,91672,91683,185627,185650,1,2206
312,"GAA","GAC","E","D",1,93967,0,91683,1,185650,1.57027554549139,2207
312,"GAA","GAT","E","D",1,93967,0,91683,1,185650,1.57027554549139,2208
312,"GAA","GGA","E","G",0,93967,1,91683,1,185650,1.59979016353682,2209
312,"GAA","GTA","E","V",0,93967,1,91683,1,185650,1.59979016353682,2210
312,"GAA","TAA","E",".",10,93967,8,91683,18,185650,0.88464042713461,2211
313,"TTT","ATT","F","I",1,92941,0,90525,1,183466,1.5674851524629,2212
313,"TTT","TAT","F","Y",0,92941,2,90525,2,183466,2.29743624523283,2213
313,"TTT","TTA","F","L",0,92941,1,90525,1,183466,1.59911356901326,2214
313,"TTT","TTT","F","F",92940,92941,90522,90525,183462,183466,1,2215
314,"ATT","AAT","I","N",1,94751,0,88333,1,183084,1.49886613706873,2216
314,"ATT","ACT","I","T",1,94751,0,88333,1,183084,1.49886613706873,2217
314,"ATT","ATC","I","I",0,94751,2,88333,2,183084,2.2894139918332,2218
314,"ATT","ATT","I","I",94747,94751,88331,88333,183078,183084,1,2219
314,"ATT","GTT","I","V",2,94751,0,88333,2,183084,2.17729090870173,2220
315,"GAG","AAG","E","K",2,95246,0,87399,2,182645,2.14950810687166,2221
315,"GAG","CAG","E","Q",0,95246,1,87399,1,182645,1.57738835975474,2222
315,"GAG","GAA","E","E",1,95246,2,87399,3,182645,1.12891287263437,2223
315,"GAG","GAC","E","D",0,95246,1,87399,1,182645,1.57738835975474,2224
315,"GAG","GAG","E","E",95202,95246,87373,87399,182575,182645,1,2225
315,"GAG","GAT","E","D",7,95246,4,87399,11,182645,1.14939094020075,2226
315,"GAG","GCG","E","A",1,95246,0,87399,1,182645,1.47457347706104,2227
315,"GAG","GGG","E","G",19,95246,5,87399,24,182645,2.33783742528645,2228
315,"GAG","GTG","E","V",3,95246,1,87399,4,182645,1.47457347706104,2229
315,"GAG","TAG","E",".",11,95246,12,87399,23,182645,0.701067763249363,2230
316,"AGC","AAC","S","N",3,96313,5,84905,8,181218,1.10771548371904,2231
316,"AGC","AGA","S","R",13,96313,11,84905,24,181218,0.721819384473169,2232
316,"AGC","AGC","S","S",96264,96313,84878,84905,181142,181218,1,2233
316,"AGC","AGG","S","R",2,96313,0,84905,2,181218,2.07905501560317,2234
316,"AGC","AGT","S","S",11,96313,3,84905,14,181218,2.07905501560317,2235
316,"AGC","ATC","S","I",17,96313,5,84905,22,181218,2.07905501560317,2236
316,"AGC","GGC","S","G",2,96313,3,84905,5,181218,0.938135211684964,2237
316,"AGC","TGC","S","C",1,96313,0,84905,1,181218,1.41335905121636,2238
317,"TCA","ACA","S","T",1,95717,1,83783,2,179500,0.568754606940164,2239
317,"TCA","CCA","S","P",5,95717,11,83783,16,179500,1.56152127590381,2240
317,"TCA","TAA","S",".",13,95717,11,83783,24,179500,0.714273080876848,2241
317,"TCA","TCA","S","S",95696,95717,83758,83783,179454,179500,1,2242
317,"TCA","TCG","S","S",1,95717,2,83783,3,179500,1.10395341099388,2243
317,"TCA","TTA","S","L",1,95717,0,83783,1,179500,1.4022328997314,2244
318,"AAG","AAA","K","K",3,95675,4,83174,7,178849,0.840748193012457,2245
318,"AAG","AAG","K","K",95657,95675,83150,83174,178807,178849,1,2246
318,"AAG","AAT","K","N",7,95675,5,83174,12,178849,0.851555992989967,2247
318,"AAG","ACG","K","T",1,95675,2,83174,3,178849,1.10047745312424,2248
318,"AAG","AGG","K","R",6,95675,7,83174,13,178849,0.723542120447505,2249
318,"AAG","ATG","K","M",1,95675,2,83174,3,178849,1.10047745312424,2250
318,"AAG","GAG","K","E",0,95675,4,83174,4,178849,3.24865210694946,2251
319,"GAC","AAC","D","N",5,97941,2,82767,7,180708,1.34997670440025,2252
319,"GAC","CAC","D","H",1,97941,1,82767,2,180708,0.539024618981467,2253
319,"GAC","GAA","D","E",7,97941,1,82767,8,180708,2.52006002261265,2254
319,"GAC","GAC","D","D",97908,97941,82750,82767,180658,180708,1,2255
319,"GAC","GAG","D","E",0,97941,1,82767,1,180708,1.55060763732038,2256
319,"GAC","GAT","D","D",6,97941,5,82767,11,180708,0.6791942051601,2257
319,"GAC","GGC","D","G",13,97941,6,82767,19,180708,1.34997670440025,2258
319,"GAC","TAC","D","Y",1,97941,1,82767,2,180708,0.539024618981467,2259
320,"GCC","ACC","A","T",27,97893,24,81295,51,179188,0.623319382612291,2260
320,"GCC","GAC","A","D",6,97893,7,81295,13,179188,0.691035892341864,2261
320,"GCC","GCA","A","A",4,97893,4,81295,8,179188,0.524526987317244,2262
320,"GCC","GCC","A","A",97821,97893,81236,81295,179057,179188,1,2263
320,"GCC","GCT","A","A",12,97893,8,81295,20,179188,0.891554931122729,2264
320,"GCC","GTC","A","V",7,97893,11,81295,18,179188,1.07829373415988,2265
320,"GCC","TCC","A","S",16,97893,5,81295,21,179188,1.87739154849052,2266
321,"GGG","AGG","G","R",3,101059,7,81485,10,182544,1.5368622780899,2267
321,"GGG","CGG","G","R",1,101059,0,81485,1,182544,1.28090831406751,2268
321,"GGG","GAG","G","E",2,101059,4,81485,6,182544,1.23190546953547,2269
321,"GGG","GCG","G","A",0,101059,1,81485,1,182544,1.5368622780899,2270
321,"GGG","GGA","G","G",5,101059,3,81485,8,182544,0.901156098751737,2271
321,"GGG","GGC","G","G",0,101059,1,81485,1,182544,1.5368622780899,2272
321,"GGG","GGG","G","G",101037,101059,81457,81485,182494,182544,1,2273
321,"GGG","GGT","G","G",3,101059,2,81485,5,182544,0.76802953765719,2274
321,"GGG","GTG","G","V",6,101059,8,81485,14,182544,0.834229227964231,2275
321,"GGG","TGG","G","W",2,101059,2,81485,4,182544,0.500761361778087,2276
322,"TTT","CTT","F","L",1,104112,0,81876,1,185988,1.24520105703327,2277
322,"TTT","TCT","F","S",0,104112,1,81876,1,185988,1.53005011799786,2278
322,"TTT","TTC","F","F",2,104112,5,81876,7,185988,1.53005011799786,2279
322,"TTT","TTT","F","F",104109,104112,81870,81876,185979,185988,1,2280
323,"CCA","ACA","P","T",10,103452,2,83012,12,186464,2.26790617051652,2281
323,"CCA","CAA","P","Q",3,103452,3,83012,6,186464,0.497174497894639,2282
323,"CCA","CCA","P","P",103412,103452,82992,83012,186404,186464,1,2283
323,"CCA","CCC","P","P",1,103452,0,83012,1,186464,1.27432246094037,2284
323,"CCA","CCG","P","P",14,103452,7,83012,21,186464,1.18304730991546,2285
323,"CCA","CCT","P","P",2,103452,2,83012,4,186464,0.497174497894639,2286
323,"CCA","CTA","P","L",6,103452,3,83012,9,186464,1.08939072621648,2287
323,"CCA","GCA","P","A",1,103452,0,83012,1,186464,1.27432246094037,2288
323,"CCA","TCA","P","S",2,103452,3,83012,5,186464,0.884530537489055,2289
323,"CCA","TTT","P","F",1,103452,0,83012,1,186464,1.27432246094037,2290
324,"GTC","ATC","V","I",9,102358,8,84500,17,186858,0.610505513262461,2291
324,"GTC","CTC","V","L",1,102358,1,84500,2,186858,0.519688165446671,2292
324,"GTC","GAC","V","D",1,102358,0,84500,1,186858,1.31533872588294,2293
324,"GTC","GCC","V","A",2,102358,2,84500,4,186858,0.519688165446671,2294
324,"GTC","GTA","V","V",10,102358,8,84500,18,186858,0.702130715361591,2295
324,"GTC","GTC","V","V",102333,102358,84479,84500,186812,186858,1,2296
324,"GTC","GTT","V","V",0,102358,1,84500,1,186858,1.54361925859734,2297
324,"GTC","TTC","V","F",2,102358,1,84500,3,186858,0.92955526312603,2298
325,"ATC","ACC","I","T",3,103080,1,85088,4,188168,1.31525514309941,2299
325,"ATC","ATA","I","I",7,103080,5,85088,12,188168,0.793636139633101,2300
325,"ATC","ATC","I","I",103056,103080,85071,85088,188127,188168,1,2301
325,"ATC","ATT","I","I",13,103080,8,85088,21,188168,0.974137333739269,2302
325,"ATC","GTC","I","V",1,103080,3,85088,4,188168,1.54360262824982,2303
326,"AAC","AAA","N","K",5,102035,5,85048,10,187083,0.527507577882867,2304
326,"AAC","AAC","N","N",102022,102035,85034,85048,187056,187083,1,2305
326,"AAC","AAG","N","K",0,102035,1,85048,1,187083,1.54643487845695,2306
326,"AAC","AAT","N","N",4,102035,6,85048,10,187083,0.976332831041511,2307
326,"AAC","ACC","N","T",1,102035,0,85048,1,187083,1.32940980662627,2308
326,"AAC","CAC","N","H",0,102035,1,85048,1,187083,1.54643487845695,2309
326,"AAC","GAC","N","D",3,102035,1,85048,4,187083,1.32940980662627,2310
327,"ACA","AAA","T","K",6,102316,2,86424,8,188740,1.58624789037087,2311
327,"ACA","ACA","T","T",102301,102316,86421,86424,188722,188740,1,2312
327,"ACA","ACG","T","T",1,102316,0,86424,1,188740,1.34925889610591,2313
327,"ACA","ACT","T","T",1,102316,0,86424,1,188740,1.34925889610591,2314
327,"ACA","AGA","T","R",1,102316,0,86424,1,188740,1.34925889610591,2315
327,"ACA","ATA","T","I",3,102316,1,86424,4,188740,1.34925889610591,2316
327,"ACA","CCA","T","P",1,102316,0,86424,1,188740,1.34925889610591,2317
327,"ACA","GCA","T","A",2,102316,0,86424,2,188740,2.00455333113372,2318
328,"CCA","ACA","P","T",1,101556,2,87719,3,189275,1.09732684700254,2319
328,"CCA","CAA","P","Q",8,101556,5,87719,13,189275,0.9853797001619,2320
328,"CCA","CCA","P","P",101539,101556,87709,87719,189248,189275,1,2321
328,"CCA","CCG","P","P",1,101556,1,87719,2,189275,0.557411160948554,2322
328,"CCA","CTA","P","L",4,101556,1,87719,5,189275,1.73402679400442,2323
328,"CCA","TCA","P","S",3,101556,1,87719,4,189275,1.38243306839696,2324
329,"AGT","AAT","S","N",1,100848,2,88487,3,189335,1.10518623694873,2325
329,"AGT","AGA","S","R",0,100848,2,88487,2,189335,2.27929464517405,2326
329,"AGT","AGC","S","S",2,100848,1,88487,3,189335,1.00504138228291,2327
329,"AGT","AGG","S","R",1,100848,0,88487,1,189335,1.40588795904363,2328
329,"AGT","AGT","S","S",100843,100848,88477,88487,189320,189335,1,2329
329,"AGT","ATT","S","I",1,100848,4,88487,5,189335,1.9487328489615,2330
329,"AGT","GGT","S","G",0,100848,1,88487,1,189335,1.56230161046795,2331
330,"AAA","AAA","K","K",101146,101149,88276,88278,189422,189427,1,2332
330,"AAA","AAG","K","K",1,101149,0,88278,1,189427,1.3979353966052,2333
330,"AAA","ACA","K","T",1,101149,0,88278,1,189427,1.3979353966052,2334
330,"AAA","AGA","K","R",0,101149,1,88278,1,189427,1.56060664918553,2335
330,"AAA","GAA","K","E",0,101149,1,88278,1,189427,1.56060664918553,2336
330,"AAA","TAA","K",".",1,101149,0,88278,1,189427,1.3979353966052,2337
331,"ACA","AAA","T","K",2,100943,7,88235,9,189178,2.0636988357457,2338
331,"ACA","ACA","T","T",100938,100943,88223,88235,189161,189178,1,2339
331,"ACA","ACG","T","T",0,100943,1,88235,1,189178,1.56107366963784,2340
331,"ACA","AGA","T","R",0,100943,1,88235,1,189178,1.56107366963784,2341
331,"ACA","ATA","T","I",1,100943,2,88235,3,189178,1.1032460000621,2342
331,"ACA","GCA","T","A",2,100943,1,88235,3,189178,1.00020904443339,2343
332,"AAG","AAG","K","K",100020,100036,87498,87502,187518,187538,1,2344
332,"AAG","AAT","K","N",7,100036,1,87502,8,187538,2.58358816595699,2345
332,"AAG","ACG","K","T",1,100036,0,87502,1,187538,1.40146475283771,2346
332,"AAG","AGG","K","R",4,100036,2,87502,6,187538,1.13968851416802,2347
332,"AAG","ATG","K","M",3,100036,1,87502,4,187538,1.40146475283771,2348
332,"AAG","GAG","K","E",1,100036,0,87502,1,187538,1.40146475283771,2349
333,"TTG","CTG","L","L",0,97791,2,89519,2,187310,2.28624527938864,2350
333,"TTG","TCG","L","S",1,97791,2,89519,3,187310,1.12750082431256,2351
333,"TTG","TTA","L","L",2,97791,4,89519,6,187310,1.28528750671607,2352
333,"TTG","TTC","L","F",1,97791,0,89519,1,187310,1.4705707741518,2353
333,"TTG","TTG","L","L",97783,97791,89509,89519,187292,187310,1,2354
333,"TTG","TTT","L","F",4,97791,2,89519,6,187310,1.20224595598327,2355
334,"GAG","AAG","E","K",1,98439,0,89621,1,188060,1.46220558748113,2356
334,"GAG","GAA","E","E",2,98439,2,89621,4,188060,0.603696537327828,2357
334,"GAG","GAG","E","E",98404,98439,89589,89621,187993,188060,1,2358
334,"GAG","GAT","E","D",21,98439,18,89621,39,188060,0.747293675391681,2359
334,"GAG","GGG","E","G",10,98439,5,89621,15,188060,1.33128717725374,2360
334,"GAG","GTG","E","V",0,98439,3,89621,3,188060,2.82309567349222,2361
334,"GAG","TAG","E",".",1,98439,4,89621,5,188060,1.95711383768817,2362
335,"CCT","ACT","P","T",5,97129,12,90193,17,187322,1.71499806350513,2363
335,"CCT","CAT","P","H",7,97129,3,90193,10,187322,1.49265265553926,2364
335,"CCT","CCA","P","P",1,97129,2,90193,3,187322,1.13533639669404,2365
335,"CCT","CCC","P","P",7,97129,6,90193,13,187322,0.754320028323153,2366
335,"CCT","CCT","P","P",97099,97129,90162,90193,187261,187322,1,2367
335,"CCT","CTT","P","L",1,97129,2,90193,3,187322,1.13533639669404,2368
335,"CCT","TCT","P","S",9,97129,6,90193,15,187322,1.01509780152355,2369
336,"AGT","AAT","S","N",2,96972,3,92525,5,189497,0.988812677577504,2370
336,"AGT","AGA","S","R",0,96972,3,92525,3,189497,2.82792072918501,2371
336,"AGT","AGT","S","S",96966,96972,92513,92525,189479,189497,1,2372
336,"AGT","ATT","S","I",2,96972,5,92525,7,189497,1.59132755090932,2373
336,"AGT","CGT","S","R",0,96972,1,92525,1,189497,1.59132755090932,2374
336,"AGT","GGT","S","G",1,96972,0,92525,1,189497,1.53494126097045,2375
336,"AGT","TGT","S","C",1,96972,0,92525,1,189497,1.53494126097045,2376
337,"GTT","ATT","V","I",3,96115,2,93406,5,189521,0.985405422204873,2377
337,"GTT","GCT","V","A",0,96115,1,93406,1,189521,1.59825157476031,2378
337,"GTT","GGT","V","G",1,96115,0,93406,1,189521,1.56392156982335,2379
337,"GTT","GTT","V","V",96107,96115,93396,93406,189503,189521,1,2380
337,"GTT","TTT","V","F",4,96115,7,93406,11,189521,1.25401361005089,2381
338,"TTC","ATC","F","I",1,95291,0,94106,1,189397,1.58944649910717,2382
338,"TTC","CTC","F","L",1,95291,0,94106,1,189397,1.58944649910717,2383
338,"TTC","TCC","F","S",2,95291,3,94106,5,189397,1.01270453528488,2384
338,"TTC","TTA","F","L",10,95291,10,94106,20,189397,0.680699459377154,2385
338,"TTC","TTC","F","F",95275,95291,94089,94106,189364,189397,1,2386
338,"TTC","TTG","F","L",1,95291,1,94106,2,189397,0.680699459377154,2387
338,"TTC","TTT","F","F",1,95291,3,94106,4,189397,1.60447740191732,2388
339,"CAC","AAC","H","N",2,94900,3,92732,5,187632,1.00522513534935,2389
339,"CAC","CAA","H","Q",1,94900,6,92732,7,187632,2.580576205402,2390
339,"CAC","CAC","H","H",94889,94900,92717,92732,187606,187632,1,2391
339,"CAC","CAG","H","Q",2,94900,0,92732,2,187632,2.26100255085952,2392
339,"CAC","CAT","H","H",4,94900,2,92732,6,187632,1.29529368379564,2393
339,"CAC","CGC","H","R",1,94900,1,92732,2,187632,0.670259552262831,2394
339,"CAC","CTC","H","L",0,94900,1,92732,1,187632,1.6003456252198,2395
339,"CAC","GAC","H","D",0,94900,1,92732,1,187632,1.6003456252198,2396
339,"CAC","TAC","H","Y",1,94900,1,92732,2,187632,0.670259552262831,2397
340,"CAG","AAG","Q","K",4,93821,5,93380,9,187201,0.88818076775856,2398
340,"CAG","CAA","Q","Q",5,93821,1,93380,6,187201,2.29418314620462,2399
340,"CAG","CAG","Q","Q",93795,93821,93358,93380,187153,187201,1,2400
340,"CAG","CAT","Q","H",5,93821,6,93380,11,187201,0.855187252802815,2401
340,"CAG","CGG","Q","R",4,93821,5,93380,9,187201,0.88818076775856,2402
340,"CAG","CTG","Q","L",0,93821,1,93380,1,187201,1.60757690425879,2403
340,"CAG","TAG","Q",".",8,93821,4,93380,12,187201,1.43743407325097,2404
341,"GTC","ATC","V","I",2,91797,2,93532,4,185329,0.674509553885547,2405
341,"GTC","GCC","V","A",1,91797,1,93532,2,185329,0.674509553885547,2406
341,"GTC","GTA","V","V",18,91797,12,93532,30,185329,1.13113260238885,2407
341,"GTC","GTC","V","V",91771,91797,93514,93532,185285,185329,1,2408
341,"GTC","GTG","V","V",0,91797,2,93532,2,185329,2.26878315410279,2409
341,"GTC","GTT","V","V",2,91797,1,93532,3,185329,1.16722685387775,2410
341,"GTC","TTC","V","F",3,91797,0,93532,3,185329,2.83103862576383,2411
342,"TTT","ATT","F","I",2,89782,0,94590,2,184372,2.29261367947766,2412
342,"TTT","CTT","F","L",1,89782,0,94590,1,184372,1.58939465403056,2413
342,"TTT","GTT","F","V",1,89782,1,94590,2,184372,0.642265044777465,2414
342,"TTT","TCT","F","S",2,89782,0,94590,2,184372,2.29261367947766,2415
342,"TTT","TTA","F","L",0,89782,1,94590,1,184372,1.52673551796838,2416
342,"TTT","TTC","F","F",4,89782,1,94590,5,184372,1.96722163212961,2417
342,"TTT","TTT","F","F",89772,89782,94587,94590,184359,184372,1,2418
343,"GAG","AAG","E","K",1,90984,3,96545,4,187529,1.51545789326639,2419
343,"GAG","GAA","E","E",3,90984,2,96545,5,187529,0.980449418157933,2420
343,"GAG","GAG","E","E",90932,90984,96503,96545,187435,187529,1,2421
343,"GAG","GAT","E","D",8,90984,12,96545,20,187529,1.04818963885685,2422
343,"GAG","GCG","E","A",1,90984,2,96545,3,187529,1.09785247463118,2423
343,"GAG","GGG","E","G",19,90984,9,96545,28,187529,1.58675789181999,2424
343,"GAG","GTG","E","V",4,90984,4,96545,8,187529,0.635452487335202,2425
343,"GAG","TAG","E",".",16,90984,10,96545,26,187529,1.18671655001661,2426
344,"GGG","AGG","G","R",3,91005,6,98478,9,189483,1.28523427613588,2427
344,"GGG","CGG","G","R",0,91005,1,98478,1,189483,1.48527568252375,2428
344,"GGG","GAG","G","E",10,91005,4,98478,14,189483,1.73942101083683,2429
344,"GGG","GGA","G","G",2,91005,4,98478,6,189483,1.2156095649499,2430
344,"GGG","GGC","G","G",1,91005,0,98478,1,189483,1.57981251750796,2431
344,"GGG","GGG","G","G",90971,91005,98438,98478,189409,189483,1,2432
344,"GGG","GGT","G","G",11,91005,10,98478,21,189483,0.714971450200169,2433
344,"GGG","GTG","G","V",3,91005,8,98478,11,189483,1.67215093865964,2434
344,"GGG","TGG","G","W",4,91005,7,98478,11,189483,1.15887823722716,2435
345,"AAC","AAA","N","K",5,86645,6,98883,11,185528,0.715080642611703,2436
345,"AAC","AAC","N","N",86601,86645,98866,98883,185467,185528,1,2437
345,"AAC","AAT","N","N",6,86645,6,98883,12,185528,0.569440894870193,2438
345,"AAC","AGC","N","S",1,86645,1,98883,2,185528,0.569440894870193,2440
345,"AAC","GAC","N","D",3,86645,3,98883,6,185528,0.569440894870193,2441
346,"AAA","AAA","K","K",87387,87395,99821,99845,187208,187240,1,2442
346,"AAA","AAC","K","N",0,87395,2,99845,2,187240,2.06655000689871,2443
346,"AAA","AAG","K","K",2,87395,5,99845,7,187240,1.40255364202733,2444
346,"AAA","AAT","K","N",3,87395,8,99845,11,187240,1.58511661762329,2445
346,"AAA","AGA","K","R",1,87395,5,99845,6,187240,2.06655000689871,2446
346,"AAA","GAA","K","E",2,87395,4,99845,6,187240,1.14067101352836,2447
347,"GAA","AAA","E","K",0,88028,4,101135,4,189163,2.99280976800044,2448
347,"GAA","GAA","E","E",88017,88028,101118,101135,189135,189163,1,2449
347,"GAA","GAG","E","E",1,88028,0,101135,1,189163,1.55975708756,2450
347,"GAA","GAT","E","D",0,88028,1,101135,1,189163,1.3939305398,2451
347,"GAA","GTA","E","V",0,88028,1,101135,1,189163,1.3939305398,2452
347,"GAA","TAA","E",".",10,88028,11,101135,21,189163,0.642740047765593,2453
348,"CCA","ACA","P","T",4,86773,2,101876,6,188649,1.25367865322288,2454
348,"CCA","CAA","P","Q",8,86773,5,101876,13,188649,1.09038809132875,2455
348,"CCA","CCA","P","P",86757,86773,101861,101876,188618,188649,1,2456
348,"CCA","CCG","P","P",0,86773,1,101876,1,188649,1.3614160325031,2457
348,"CCA","CCT","P","P",0,86773,1,101876,1,188649,1.3614160325031,2458
348,"CCA","CTA","P","L",2,86773,2,101876,4,188649,0.545475475596518,2459
348,"CCA","GCA","P","A",0,86773,1,101876,1,188649,1.3614160325031,2460
348,"CCA","TCA","P","S",2,86773,3,101876,5,188649,0.828399325826445,2461
349,"GCA","ACA","A","T",7,85530,7,102448,14,187978,0.52881049554923,2462
349,"GCA","CCA","A","P",0,85530,2,102448,2,187978,1.98406072975807,2463
349,"GCA","GAA","A","E",9,85530,9,102448,18,187978,0.52881049554923,2464
349,"GCA","GCA","A","A",85478,85530,102392,102448,187870,187978,1,2465
349,"GCA","GCG","A","A",1,85530,1,102448,2,187978,0.52881049554923,2466
349,"GCA","GCT","A","A",1,85530,0,102448,1,187978,1.54690540404594,2467
349,"GCA","GGA","A","G",2,85530,0,102448,2,187978,2.27180754850805,2468
349,"GCA","GTA","A","V",27,85530,25,102448,52,187978,0.618787757791635,2469
349,"GCA","TCA","A","S",5,85530,12,102448,17,187978,1.45199258198734,2470
350,"GTA","ATA","V","I",5,86584,8,102634,13,189218,0.956059415946344,2471
350,"GTA","GTA","V","V",86576,86584,102621,102634,189197,189218,1,2472
350,"GTA","GTG","V","V",0,86584,1,102634,1,189218,1.34728790030485,2473
350,"GTA","TTA","V","L",3,86584,4,102634,7,189218,0.747683079751405,2474
351,"CTC","ATC","L","I",5,86561,2,102754,7,189315,1.54962524065358,2475
351,"CTC","CCC","L","P",3,86561,8,102754,11,189315,1.52450744864627,2476
351,"CTC","CTA","L","L",6,86561,10,102754,16,189315,1.01252283429898,2477
351,"CTC","CTC","L","L",86542,86561,102728,102754,189270,189315,1,2478
351,"CTC","CTG","L","L",0,86561,2,102754,2,189315,1.99976821340085,2479
351,"CTC","CTT","L","L",2,86561,4,102754,6,189315,1.08903401301276,2480
351,"CTC","GTC","L","V",1,86561,0,102754,1,189315,1.54962524065358,2481
351,"CTC","TTC","L","F",2,86561,0,102754,2,189315,2.27312588492191,2482
352,"AGG","AAG","R","K",1,86528,3,103284,4,189812,1.33681971565948,2483
352,"AGG","AGA","R","R",0,86528,1,103284,1,189812,1.33681971565948,2484
352,"AGG","AGC","R","S",0,86528,2,103284,2,189812,1.99000407817486,2485
352,"AGG","AGG","R","R",86500,86528,103260,103284,189760,189812,1,2486
352,"AGG","AGT","R","S",13,86528,8,103284,21,189812,1.13830800915044,2487
352,"AGG","ATG","R","M",4,86528,3,103284,7,189812,0.817234431047019,2488
352,"AGG","CGG","R","R",0,86528,1,103284,1,189812,1.33681971565948,2489
352,"AGG","GGG","R","G",8,86528,6,103284,14,189812,0.856451769362373,2490
352,"AGG","TGG","R","W",2,86528,0,103284,2,189812,2.27230414678361,2491
353,"AGT","AAT","S","N",1,85761,1,103783,2,189544,0.520482360276626,2492
353,"AGT","AGA","S","R",1,85761,0,103783,1,189544,1.5439045902423,2493
353,"AGT","AGT","S","S",85755,85761,103777,103783,189532,189544,1,2494
353,"AGT","ATT","S","I",4,85761,5,103783,9,189544,0.684756291191984,2495
354,"GGG","AGG","G","R",3,85036,5,105006,8,190042,0.906446919104867,2496
354,"GGG","GCG","G","A",0,85036,2,105006,2,190042,1.93181771403096,2497
354,"GGG","GGA","G","G",2,85036,2,105006,4,190042,0.504273860405789,2498
354,"GGG","GGG","G","G",85009,85036,104975,105006,189984,190042,1,2499
354,"GGG","GGT","G","G",4,85036,4,105006,8,190042,0.504273860405789,2500
354,"GGG","GTG","G","V",6,85036,11,105006,17,190042,1.0740457535083,2501
354,"GGG","TGG","G","W",12,85036,7,105006,19,190042,1.19283331629126,2502
355,"GAT","AAT","D","N",4,85113,3,103961,7,189074,0.803225833497322,2503
355,"GAT","CAT","D","H",0,85113,1,103961,1,189074,1.30316461711442,2504
355,"GAT","GAC","D","D",1,85113,1,103961,2,189074,0.512962386215378,2505
355,"GAT","GAT","D","D",85098,85113,103946,103961,189044,189074,1,2506
355,"GAT","GGT","D","G",1,85113,0,103961,1,189074,1.54120869462984,2507
355,"GAT","TAT","D","Y",9,85113,10,103961,19,189074,0.593868362363194,2508
356,"CCA","ACA","P","T",9,86456,11,103375,20,189831,0.696657710786328,2509
356,"CCA","CAA","P","Q",6,86456,7,103375,13,189831,0.648886456641857,2510
356,"CCA","CCA","P","P",86423,86456,103345,103375,189768,189831,1,2511
356,"CCA","CCG","P","P",6,86456,6,103375,12,189831,0.530233319618447,2512
356,"CCA","CGA","P","R",3,86456,0,103375,3,189831,2.81536852395042,2513
356,"CCA","CTA","P","L",2,86456,1,103375,3,189831,1.08157760178317,2514
356,"CCA","GCA","P","A",1,86456,0,103375,1,189831,1.54741967917667,2515
356,"CCA","TCA","P","S",6,86456,5,103375,11,189831,0.7229194843844,2516
357,"CGT","AGT","R","S",2,84801,5,102676,7,187477,1.31599631617651,2517
357,"CGT","CAT","R","H",6,84801,10,102676,16,187477,0.987460522758951,2518
357,"CGT","CGT","R","R",84773,84801,102643,102676,187416,187477,1,2519
357,"CGT","CTT","R","L",2,84801,3,102676,5,187477,0.794191166233306,2520
357,"CGT","TGT","R","C",18,84801,15,102676,33,187477,0.738250660132907,2521
358,"CTC","ATC","L","I",9,84526,8,101963,17,186489,0.653133617522024,2522
358,"CTC","CAC","L","H",1,84526,1,101963,2,186489,0.522942861496362,2523
358,"CTC","CCC","L","P",4,84526,1,101963,5,186489,1.93686722980077,2524
358,"CTC","CTA","L","L",12,84526,6,101963,18,186489,1.4197205556017,2525
358,"CTC","CTC","L","L",84494,84526,101942,101963,186436,186489,1,2526
358,"CTC","CTT","L","L",3,84526,2,101963,5,186489,0.902095532100652,2527
358,"CTC","GTC","L","V",1,84526,1,101963,2,186489,0.522942861496362,2528
358,"CTC","TTC","L","F",2,84526,2,101963,4,186489,0.522942861496362,2529
359,"AAG","AAA","K","K",1,83685,1,98772,2,182457,0.540984768037087,2530
359,"AAG","AAC","K","N",1,83685,0,98772,1,182457,1.55132087618213,2531
359,"AAG","AAG","K","K",83663,83685,98756,98772,182419,182457,1,2532
359,"AAG","AAT","K","N",5,83685,6,98772,11,182457,0.681512827040915,2533
359,"AAG","ACG","K","T",1,83685,0,98772,1,182457,1.55132087618213,2534
359,"AAG","AGG","K","R",6,83685,3,98772,9,182457,1.32977627367092,2535
359,"AAG","ATG","K","M",1,83685,1,98772,2,182457,0.540984768037087,2536
359,"AAG","GAG","K","E",6,83685,5,98772,11,182457,0.73179497690793,2537
359,"AAG","TAG","K",".",1,83685,0,98772,1,182457,1.55132087618213,2538
360,"GCC","ACC","A","T",53,83718,60,98597,113,182315,0.652146320102957,2539
360,"GCC","CCC","A","P",1,83718,2,98597,3,182315,0.963773891181366,2540
360,"GCC","GAC","A","D",15,83718,25,98597,40,182315,1.06577711915493,2541
360,"GCC","GCA","A","A",6,83718,3,98597,9,182315,1.33056978394511,2542
360,"GCC","GCC","A","A",83617,83718,98496,98597,182113,182315,1,2543
360,"GCC","GCT","A","A",5,83718,1,98597,6,182315,2.27425746561024,2544
360,"GCC","GTC","A","V",10,83718,3,98597,13,182315,2.11422917150056,2545
360,"GCC","TCC","A","S",11,83718,7,98597,18,182315,1.08879706970725,2546
361,"AAT","AAC","N","N",1,82379,0,96392,1,178771,1.55397952671716,2547
361,"AAT","AAG","N","K",1,82379,0,96392,1,178771,1.55397952671716,2548
361,"AAT","AAT","N","N",82370,82379,96390,96392,178760,178771,1,2549
361,"AAT","AGT","N","S",4,82379,2,96392,6,178771,1.25505597705106,2550
361,"AAT","ATT","N","I",2,82379,0,96392,2,178771,2.27524030494565,2551
361,"AAT","GAT","N","D",1,82379,0,96392,1,178771,1.55397952671716,2552
362,"TTT","GTT","F","V",0,83739,1,94550,1,178289,1.42015717863318,2553
362,"TTT","TTC","F","F",0,83739,2,94550,2,178289,2.08691159698336,2554
362,"TTT","TTT","F","F",83739,83739,94547,94550,178286,178289,1,2555
363,"GAA","AAA","E","K",1,86237,1,93368,2,179605,0.616813757819622,2556
363,"GAA","ACC","E","T",1,86237,0,93368,1,179605,1.57960005268597,2557
363,"GAA","CAA","E","Q",1,86237,0,93368,1,179605,1.57960005268597,2558
363,"GAA","GAA","E","E",86215,86237,93348,93368,179563,179605,1,2559
363,"GAA","GAC","E","D",0,86237,1,93368,1,179605,1.48434122274072,2560
363,"GAA","GAG","E","E",1,86237,4,93368,5,179605,1.84551197612248,2561
363,"GAA","GAT","E","D",2,86237,1,93368,3,179605,1.13237404963307,2562
363,"GAA","GGA","E","G",4,86237,7,93368,11,179605,1.15804939805817,2563
363,"GAA","TAA","E",".",11,86237,6,93368,17,179605,1.33283819866795,2564
363,"GAA","TTT","E","F",1,86237,0,93368,1,179605,1.57960005268597,2565
364,"GAG","AAG","E","K",0,85946,2,92311,2,178257,2.17498925357374,2566
364,"GAG","GAA","E","E",0,85946,1,92311,1,178257,1.4968504096583,2567
364,"GAG","GAG","E","E",85939,85946,92301,92311,178240,178257,1,2568
364,"GAG","GAT","E","D",2,85946,1,92311,3,178257,1.13683858057773,2569
364,"GAG","GCG","E","A",0,85946,1,92311,1,178257,1.4968504096583,2570
364,"GAG","GGG","E","G",0,85946,1,92311,1,178257,1.4968504096583,2571
364,"GAG","TAG","E",".",5,85946,4,92311,9,178257,0.835904175827143,2572
365,"GCT","ACT","A","T",4,87069,12,91340,16,178409,1.96616628024638,2573
365,"GCT","GAT","A","D",23,87069,20,91340,43,178409,0.795200744372936,2574
365,"GCT","GCC","A","A",9,87069,10,91340,19,178409,0.741748463134857,2575
365,"GCT","GCG","A","A",1,87069,0,91340,1,178409,1.5910220015214,2576
365,"GCT","GCT","A","A",87023,87069,91287,91340,178310,178409,1,2577
365,"GCT","GTT","A","V",1,87069,2,91340,3,178409,1.11340797082943,2578
365,"GCT","TCT","A","S",8,87069,9,91340,17,178409,0.752325952419373,2579
366,"ATA","AAA","I","K",0,85465,4,91528,4,176993,3.12669256103817,2580
366,"ATA","ACA","I","T",2,85465,1,91528,3,176993,1.13845396570708,2581
366,"ATA","ATA","I","I",85461,85465,91522,91528,176983,176993,1,2582
366,"ATA","CTA","I","L",1,85465,0,91528,1,176993,1.58349180638943,2583
366,"ATA","GTA","I","V",1,85465,0,91528,1,176993,1.58349180638943,2584
366,"ATA","TTA","I","L",0,85465,1,91528,1,176993,1.50135191622868,2585
367,"TTT","CTT","F","L",0,88683,1,89682,1,178365,1.59157322077155,2586
367,"TTT","TTT","F","F",88683,88683,89681,89682,178364,178365,1,2587
368,"TCC","ACC","S","T",0,90660,1,88022,1,178682,1.59789589845538,2588
368,"TCC","CCC","S","P",2,90660,1,88022,3,178682,1.13812104359216,2589
368,"TCC","TAC","S","Y",8,90660,6,88022,14,178682,0.939308333749016,2590
368,"TCC","TCA","S","S",2,90660,5,88022,7,178682,1.59789589845538,2591
368,"TCC","TCC","S","S",90646,90660,88007,88022,178653,178682,1,2592
368,"TCC","TCT","S","S",1,90660,1,88022,2,178682,0.664038451322663,2593
368,"TCC","TTC","S","F",1,90660,1,88022,2,178682,0.664038451322663,2594
369,"AAG","AAA","K","K",0,91545,1,86634,1,178179,1.5883311127824,2595
369,"AAG","AAG","K","K",91531,91545,86620,86634,178151,178179,1,2596
369,"AAG","AAT","K","N",3,91545,2,86634,5,178179,0.952479125384485,2597
369,"AAG","ACG","K","T",1,91545,0,86634,1,178179,1.52219839266321,2598
369,"AAG","AGG","K","R",3,91545,3,86634,6,178179,0.639520613337401,2599
369,"AAG","ATG","K","M",3,91545,1,86634,4,178179,1.52219839266321,2600
369,"AAG","GAG","K","E",4,91545,7,86634,11,178179,1.23998798607971,2601
370,"TAT","AAT","Y","N",1,92657,2,85980,3,178637,1.13496576097728,2602
370,"TAT","CAT","Y","H",2,92657,0,85980,2,178637,2.16900834970509,2603
370,"TAT","TAG","Y",".",0,92657,1,85980,1,178637,1.58125796549905,2604
370,"TAT","TAT","Y","Y",92654,92657,85977,85980,178631,178637,1,2605
371,"ATA","ACA","I","T",1,92011,0,85180,1,177191,1.48801570200936,2606
371,"ATA","ATA","I","I",92000,92011,85172,85180,177172,177191,1,2607
371,"ATA","ATG","I","M",7,92011,5,85180,12,177191,0.92572162820125,2608
371,"ATA","ATT","I","I",1,92011,3,85180,4,177191,1.58043639092122,2609
371,"ATA","GTA","I","V",2,92011,0,85180,2,177191,2.16489356069326,2610
372,"GGA","AGA","G","R",2,93085,3,85186,5,178271,0.961378850622033,2611
372,"GGA","GAA","G","E",3,93085,1,85186,4,178271,1.47019636793401,2612
372,"GGA","GGA","G","G",93071,93085,85175,85186,178246,178271,1,2613
372,"GGA","GTA","G","V",6,93085,5,85186,11,178271,0.760787573697189,2614
372,"GGA","TGA","G",".",3,93085,2,85186,5,178271,0.911852323405101,2615
373,"AAT","AAA","N","K",0,94997,1,86221,1,181218,1.57353215369241,2616
373,"AAT","AAC","N","N",0,94997,1,86221,1,181218,1.57353215369241,2617
373,"AAT","AAT","N","N",94996,94997,86214,86221,181210,181218,1,2618
373,"AAT","AGT","N","S",1,94997,0,86221,1,181218,1.4573640390667,2619
373,"AAT","GAT","N","D",0,94997,5,86221,5,181218,3.60614046564495,2620
374,"GTC","ATC","V","I",3,96052,2,85901,5,181953,0.884535698447924,2621
374,"GTC","GAA","V","E",0,96052,2,85901,2,181953,2.28236157496764,2622
374,"GTC","GAC","V","D",0,96052,2,85901,2,181953,2.28236157496764,2623
374,"GTC","GCC","V","A",4,96052,0,85901,4,181953,3.04427961916805,2624
374,"GTC","GTA","V","V",9,96052,10,85901,19,181953,0.698033252831135,2625
374,"GTC","GTC","V","V",96028,96052,85879,85901,181907,181953,1,2626
374,"GTC","GTG","V","V",2,96052,1,85901,3,181953,1.02945552112373,2627
374,"GTC","TTC","V","F",6,96052,5,85901,11,181953,0.736499395392352,2628
375,"AAC","AAA","N","K",6,98721,4,85407,10,184128,0.902976344251248,2629
375,"AAC","AAC","N","N",98703,98721,85390,85407,184093,184128,1,2630
375,"AAC","AAG","N","K",1,98721,1,85407,2,184128,0.55872169794925,2631
375,"AAC","AAT","N","N",3,98721,7,85407,10,184128,1.55781530947003,2632
375,"AAC","AGC","N","S",2,98721,0,85407,2,184128,2.04587498252056,2633
375,"AAC","ATC","N","I",0,98721,1,85407,1,184128,1.55781530947003,2634
375,"AAC","CAC","N","H",0,98721,1,85407,1,184128,1.55781530947003,2635
375,"AAC","GAC","N","D",5,98721,2,85407,7,184128,1.38472917864869,2636
375,"AAC","TAC","N","Y",0,98721,1,85407,1,184128,1.55781530947003,2637
375,"AAC","TTC","N","F",1,98721,0,85407,1,184128,1.38472917864869,2638
376,"ACA","AAA","T","K",3,100243,5,84704,8,184947,1.0865125058983,2639
376,"ACA","ACA","T","T",100236,100243,84693,84704,184929,184947,1,2640
376,"ACA","ACG","T","T",0,100243,3,84704,3,184947,2.81624186781179,2641
376,"ACA","AGA","T","R",1,100243,1,84704,2,184947,0.538782780414175,2642
376,"ACA","ATA","T","I",2,100243,1,84704,3,184947,0.957938725806825,2643
376,"ACA","GCA","T","A",1,100243,1,84704,2,184947,0.538782780414175,2644
377,"CAC","AAC","H","N",4,101753,4,83517,8,185270,0.514999973643411,2645
377,"CAC","CAA","H","Q",7,101753,3,83517,10,185270,1.30685979764915,2646
377,"CAC","CAC","H","H",101720,101753,83487,83517,185207,185270,1,2647
377,"CAC","CAG","H","Q",1,101753,0,83517,1,185270,1.30685979764915,2648
377,"CAC","CAT","H","H",12,101753,12,83517,24,185270,0.514999973643411,2649
377,"CAC","CGC","H","R",2,101753,5,83517,7,185270,1.54193788132472,2650
377,"CAC","GAC","H","D",1,101753,0,83517,1,185270,1.30685979764915,2651
377,"CAC","TAC","H","Y",6,101753,6,83517,12,185270,0.514999973643411,2652
378,"GTG","ATG","V","M",7,102236,10,83818,17,186054,0.941051486942269,2653
378,"GTG","CTG","V","L",1,102236,0,83818,1,186054,1.305138123171,2654
378,"GTG","GAG","V","E",1,102236,0,83818,1,186054,1.305138123171,2655
378,"GTG","GCG","V","A",3,102236,1,83818,4,186054,1.305138123171,2656
378,"GTG","GTA","V","V",3,102236,1,83818,4,186054,1.305138123171,2657
378,"GTG","GTG","V","V",102211,102236,83791,83818,186002,186054,1,2658
378,"GTG","GTT","V","V",9,102236,9,83818,18,186054,0.514050191882845,2659
378,"GTG","TTG","V","L",1,102236,6,83818,7,186054,2.55893512517261,2660
379,"GAT","AAT","D","N",3,105671,3,84130,6,189801,0.490936278434387,2661
379,"GAT","CAT","D","H",0,105671,1,84130,1,189801,1.53338702841147,2662
379,"GAT","GAC","D","D",0,105671,1,84130,1,189801,1.53338702841147,2663
379,"GAT","GAT","D","D",105652,105671,84114,84130,189766,189801,1,2664
379,"GAT","GGT","D","G",6,105671,3,84130,9,189801,1.07880101551856,2665
379,"GAT","TAT","D","Y",10,105671,8,84130,18,189801,0.666215369358167,2666
380,"GAG","AAG","E","K",2,107850,1,83830,3,191680,0.858412683794898,2667
380,"GAG","CAG","E","Q",1,107850,0,83830,1,191680,1.22868497363927,2668
380,"GAG","GAA","E","E",6,107850,3,83830,9,191680,1.04742831297639,2669
380,"GAG","GAG","E","E",107804,107850,83795,83830,191599,191680,1,2670
380,"GAG","GAT","E","D",5,107850,3,83830,8,191680,0.858412683794898,2671
380,"GAG","GCG","E","A",0,107850,2,83830,2,191680,2.26219877142235,2672
380,"GAG","GGG","E","G",16,107850,11,83830,27,191680,0.794151328425581,2673
380,"GAG","GTG","E","V",2,107850,0,83830,2,191680,1.86216362009041,2674
380,"GAG","TAG","E",".",14,107850,15,83830,29,191680,0.555011575832963,2675
381,"TAC","AAC","Y","N",0,107589,2,83641,2,191230,2.26221732834147,2676
381,"TAC","CAC","Y","H",3,107589,2,83641,5,191230,0.72968189412131,2677
381,"TAC","TAA","Y",".",4,107589,2,83641,6,191230,0.985362293697547,2678
381,"TAC","TAC","Y","Y",107572,107589,83627,83641,191199,191230,1,2679
381,"TAC","TAT","Y","Y",6,107589,4,83641,10,191230,0.781409276593655,2680
381,"TAC","TGC","Y","C",3,107589,4,83641,7,191230,0.773279852142877,2681
381,"TAC","TTC","Y","F",1,107589,0,83641,1,191230,1.22889360228132,2682
382,"ATG","AAG","M","K",0,107623,1,83461,1,191084,1.52637273026179,2683
382,"ATG","ACG","M","T",0,107623,1,83461,1,191084,1.52637273026179,2684
382,"ATG","ATA","M","I",12,107623,1,83461,13,191084,3.27379979673188,2685
382,"ATG","ATC","M","I",0,107623,1,83461,1,191084,1.52637273026179,2686
382,"ATG","ATG","M","M",107593,107623,83442,83461,191035,191084,1,2687
382,"ATG","ATT","M","I",15,107623,12,83461,27,191084,0.647669032341916,2688
382,"ATG","GTG","M","V",3,107623,3,83461,6,191084,0.47091308646467,2689
383,"CTG","ATG","L","M",9,106553,6,83168,15,189721,0.808033829896052,2690
383,"CTG","CCG","L","P",1,106553,1,83168,2,189721,0.475806357112422,2691
383,"CTG","CTA","L","L",9,106553,4,83168,13,189721,1.23467039955041,2692
383,"CTG","CTC","L","L",1,106553,0,83168,1,189721,1.23467039955041,2693
383,"CTG","CTG","L","L",106509,106553,83139,83168,189648,189721,1,2694
383,"CTG","CTT","L","L",4,106553,7,83168,11,189721,1.1535143258309,2695
383,"CTG","GTG","L","V",0,106553,1,83168,1,189721,1.52807846495777,2696
383,"CTG","TTG","L","L",20,106553,10,83168,30,189721,1.16960285125137,2697
384,"GAA","AAA","E","K",3,106534,4,83663,7,190197,0.779000898404493,2698
384,"GAA","GAA","E","E",106518,106534,83655,83663,190173,190197,1,2699
384,"GAA","GAC","E","D",1,106534,0,83663,1,190197,1.24334024689683,2700
384,"GAA","GAG","E","E",2,106534,0,83663,2,190197,1.8796397784158,2701
384,"GAA","GGA","E","G",2,106534,0,83663,2,190197,1.8796397784158,2702
384,"GAA","TAA","E",".",8,106534,4,83663,12,190197,1.09808283067449,2703
385,"GCA","ACA","A","T",6,106346,6,84660,12,191006,0.490964336472173,2704
385,"GCA","GAA","A","E",7,106346,13,84660,20,191006,1.30735696020729,2705
385,"GCA","GCA","A","A",106290,106346,84625,84660,190915,191006,1,2706
385,"GCA","GCG","A","A",2,106346,0,84660,2,191006,1.90285645949114,2707
385,"GCA","GCT","A","A",1,106346,1,84660,2,191006,0.490964336472173,2708
385,"GCA","GTA","A","V",29,106346,11,84660,40,191006,1.60177245933217,2709
385,"GCA","TCA","A","S",11,106346,4,84660,15,191006,1.53712796581267,2710
386,"GTG","ATG","V","M",7,105605,5,84642,12,190247,0.761745231357237,2711
386,"GTG","CTG","V","L",1,105605,0,84642,1,190247,1.27243263104616,2712
386,"GTG","GAG","V","E",0,105605,1,84642,1,190247,1.53522745373581,2713
386,"GTG","GCG","V","A",0,105605,1,84642,1,190247,1.53522745373581,2714
386,"GTG","GTA","V","V",1,105605,3,84642,4,190247,1.53522745373581,2715
386,"GTG","GTG","V","V",105584,105605,84624,84642,190208,190247,1,2716
386,"GTG","GTT","V","V",9,105605,5,84642,14,190247,1.02402975349661,2717
386,"GTG","TTG","V","L",3,105605,3,84642,6,190247,0.496147223320178,2718
387,"GAC","AAC","D","N",1,106537,0,85378,1,191915,1.27246401110882,2719
387,"GAC","CAC","D","H",1,106537,0,85378,1,191915,1.27246401110882,2720
387,"GAC","GAA","D","E",10,106537,4,85378,14,191915,1.41324325734631,2721
387,"GAC","GAC","D","D",106485,106537,85348,85378,191833,191915,1,2722
387,"GAC","GAT","D","D",13,106537,6,85378,19,191915,1.27246401110882,2723
387,"GAC","GGC","D","G",4,106537,2,85378,6,191915,1.02405769000086,2724
387,"GAC","TAC","D","Y",23,106537,18,85378,41,191915,0.705573503429043,2725
388,"CAC","AAC","H","N",13,106930,3,86028,16,192958,2.1895593678087,2726
388,"CAC","CAA","H","Q",5,106930,1,86028,6,192958,1.92089420541135,2727
388,"CAC","CAC","H","H",106901,106930,86017,86028,192918,192958,1,2728
388,"CAC","CAT","H","H",3,106930,2,86028,5,192958,0.765944148795095,2729
388,"CAC","CGC","H","R",2,106930,3,86028,5,192958,0.885925931621746,2730
388,"CAC","CTC","H","L",1,106930,0,86028,1,192958,1.27809779496728,2731
388,"CAC","GAC","H","D",2,106930,0,86028,2,192958,1.92089420541135,2732
388,"CAC","TAC","H","Y",3,106930,2,86028,5,192958,0.765944148795095,2733
389,"TAC","CAC","Y","H",3,105779,3,86285,6,192064,0.510183325176034,2734
389,"TAC","TAA","Y",".",6,105779,3,86285,9,192064,1.11132754614209,2735
389,"TAC","TAC","Y","Y",105750,105779,86275,86285,192025,192064,1,2736
389,"TAC","TAG","Y",".",1,105779,0,86285,1,192064,1.29811486148536,2737
389,"TAC","TAT","Y","Y",15,105779,4,86285,19,192064,2.05613559193332,2738
389,"TAC","TGC","Y","C",4,105779,0,86285,4,192064,2.8701641082942,2739
390,"GCA","ACA","A","T",31,105123,18,84829,49,189952,1.04607161242949,2740
390,"GCA","GAA","A","E",2,105123,10,84829,12,189952,2.64584773692336,2741
390,"GCA","GCA","A","A",105057,105123,84761,84829,189818,189952,1,2742
390,"GCA","GCC","A","A",3,105123,3,84829,6,189952,0.501347704114579,2743
390,"GCA","GCG","A","A",8,105123,16,84829,24,189952,1.43956162896152,2744
390,"GCA","GCT","A","A",2,105123,2,84829,4,189952,0.501347704114579,2745
390,"GCA","GTA","A","V",12,105123,10,84829,22,189952,0.646668999334437,2746
390,"GCA","TCA","A","S",8,105123,9,84829,17,189952,0.634199751212358,2747
391,"GGC","AGC","G","S",2,103897,3,85514,5,189411,0.897983898954916,2748
391,"GGC","GAC","G","D",34,103897,44,85514,78,189411,0.845839402284552,2749
391,"GGC","GGA","G","G",12,103897,15,85514,27,189411,0.78466126418896,2750
391,"GGC","GGC","G","G",103819,103897,85414,85514,189233,189411,1,2751
391,"GGC","GGT","G","G",18,103897,18,85514,36,189411,0.516929867114305,2752
391,"GGC","GTC","G","V",9,103897,14,85514,23,189411,1.07393411209246,2753
391,"GGC","TGC","G","C",3,103897,6,85514,9,189411,1.318917554618,2754
392,"CAA","AAA","Q","K",4,103724,10,87548,14,191272,1.71420566690954,2755
392,"CAA","CAA","Q","Q",103714,103724,87530,87548,191244,191272,1,2756
392,"CAA","CAG","Q","Q",4,103724,1,87548,5,191272,1.69591764298823,2757
392,"CAA","CAT","Q","H",0,103724,1,87548,1,191272,1.55016834752426,2758
392,"CAA","CGA","Q","R",0,103724,3,87548,3,191272,2.81614278607948,2759
392,"CAA","GAA","Q","E",0,103724,1,87548,1,191272,1.55016834752426,2760
392,"CAA","TAA","Q",".",2,103724,2,87548,4,191272,0.537816129025766,2761
393,"CTA","ATA","L","I",2,103107,4,85518,6,188625,1.24292728997399,2762
393,"CTA","CAA","L","Q",0,103107,1,85518,1,188625,1.54499881882566,2763
393,"CTA","CCA","L","P",1,103107,1,85518,2,188625,0.523524306939686,2764
393,"CTA","CGA","L","R",0,103107,1,85518,1,188625,1.54499881882566,2765
393,"CTA","CTA","L","L",103093,103107,85509,85518,188602,188625,1,2766
393,"CTA","CTG","L","L",3,103107,1,85518,4,188625,1.32225287879912,2767
393,"CTA","GTA","L","V",1,103107,0,85518,1,188625,1.32225287879912,2768
393,"CTA","TTA","L","L",7,103107,1,85518,8,188625,2.4855279097174,2769
394,"GCC","ACC","A","T",6,102882,9,86058,15,188940,1.00813488933228,2770
394,"GCC","GAC","A","D",8,102882,12,86058,20,188940,1.02463859213335,2771
394,"GCC","GCA","A","A",6,102882,4,86058,10,188940,0.863459614823908,2772
394,"GCC","GCC","A","A",102813,102882,85999,86058,188812,188940,1,2773
394,"GCC","GCT","A","A",6,102882,3,86058,9,188940,1.14509347871824,2774
394,"GCC","GGC","A","G",1,102882,0,86058,1,188940,1.33465217561596,2775
394,"GCC","GTC","A","V",31,102882,22,86058,53,188940,0.856272314968203,2776
394,"GCC","TCC","A","S",11,102882,9,86058,20,188940,0.696901524285125,2777
395,"ACC","AAC","T","N",0,102686,2,86324,2,189010,2.27280866959946,2778
395,"ACC","ACA","T","T",5,102686,4,86324,9,189010,0.701879138216491,2779
395,"ACC","ACC","T","T",102678,102686,86312,86324,188990,189010,1,2780
395,"ACC","ACT","T","T",0,102686,1,86324,1,189010,1.54897114744407,2781
395,"ACC","AGC","T","S",0,102686,1,86324,1,189010,1.54897114744407,2782
395,"ACC","ATC","T","I",1,102686,4,86324,5,189010,1.9396944813583,2783
395,"ACC","CCC","T","P",1,102686,0,86324,1,189010,1.34195082661482,2784
395,"ACC","TCC","T","S",1,102686,0,86324,1,189010,1.34195082661482,2785
396,"CTA","ATA","L","I",15,103204,8,87389,23,190593,1.18361665689546,2786
396,"CTA","CAA","L","Q",2,103204,0,87389,2,190593,2.00865155503027,2787
396,"CTA","CCA","L","P",3,103204,6,87389,9,190593,1.32959937684532,2788
396,"CTA","CTA","L","L",103181,103204,87371,87389,190552,190593,1,2789
396,"CTA","CTC","L","L",1,103204,0,87389,1,190593,1.35276748140972,2790
396,"CTA","CTG","L","L",2,103204,1,87389,3,190593,0.960619554932385,2791
396,"CTA","CTT","L","L",0,103204,1,87389,1,190593,1.55117913475292,2792
396,"CTA","GTA","L","V",0,103204,1,87389,1,190593,1.55117913475292,2793
396,"CTA","TTA","L","L",0,103204,1,87389,1,190593,1.55117913475292,2794
397,"GAT","AAT","D","N",0,103410,1,88460,1,191870,1.55431867542377,2795
397,"GAT","GAC","D","D",3,103410,0,88460,3,191870,2.54237208189179,2796
397,"GAT","GAG","D","E",2,103410,0,88460,2,191870,2.02640375787045,2797
397,"GAT","GAT","D","D",103396,103410,88454,88460,191850,191870,1,2798
397,"GAT","GGT","D","G",0,103410,2,88460,2,191870,2.27540519271054,2799
397,"GAT","TAT","D","Y",9,103410,3,88460,12,191870,1.71813702850787,2800
398,"ATC","ACC","I","T",0,102890,3,90049,3,192939,2.81935273100723,2801
398,"ATC","ATA","I","I",11,102890,8,90049,19,192939,0.859410905511082,2802
398,"ATC","ATC","I","I",102869,102890,90032,90049,192901,192939,1,2803
398,"ATC","ATT","I","I",9,102890,6,90049,15,192939,0.9412780152597,2804
398,"ATC","GTC","I","V",1,102890,0,90049,1,192939,1.40216283874468,2805
399,"AGC","AAC","S","N",10,103279,13,90698,23,193977,0.871638716515091,2806
399,"AGC","ACC","S","T",1,103279,0,90698,1,193977,1.4070679087468,2807
399,"AGC","AGA","S","R",8,103279,15,90698,23,193977,1.36901712727164,2808
399,"AGC","AGC","S","S",103239,103279,90650,90698,193889,193977,1,2809
399,"AGC","AGT","S","S",7,103279,4,90698,11,193977,1.08981924234301,2810
399,"AGC","ATC","S","I",9,103279,11,90698,20,193977,0.793440749746829,2811
399,"AGC","GGC","S","G",4,103279,5,90698,9,193977,0.793440749746829,2812
399,"AGC","TGC","S","C",1,103279,0,90698,1,193977,1.4070679087468,2813
400,"ACT","AAT","T","N",3,103641,0,91321,3,194962,2.59686963756024,2814
400,"ACT","ACA","T","T",1,103641,1,91321,2,194962,0.574562722201364,2815
400,"ACT","ACC","T","T",3,103641,9,91321,12,194962,1.94966787951562,2816
400,"ACT","ACT","T","T",103632,103641,91311,91321,194943,194962,1,2817
400,"ACT","ATT","T","I",1,103641,0,91321,1,194962,1.41230668501425,2818
400,"ACT","TCT","T","S",1,103641,0,91321,1,194962,1.41230668501425,2819
401,"GAA","AAA","E","K",2,102194,5,93517,7,195711,1.57635437117264,2820
401,"GAA","CAA","E","Q",1,102194,1,93517,2,195711,0.608290934806135,2821
401,"GAA","GAA","E","E",102182,102194,93500,93517,195682,195711,1,2822
401,"GAA","GAG","E","E",0,102194,1,93517,1,195711,1.57635437117264,2823
401,"GAA","TAA","E",".",9,102194,10,93517,19,195711,0.716516316701237,2824
402,"CCA","ACA","P","T",3,101457,8,93923,11,195380,1.77820838578662,2825
402,"CCA","CAA","P","Q",6,101457,10,93923,16,195380,1.20180936679292,2826
402,"CCA","CCA","P","P",101442,101457,93895,93923,195337,195380,1,2827
402,"CCA","CCG","P","P",2,101457,1,93923,3,195380,1.07420664867042,2828
402,"CCA","CTA","P","L",1,101457,4,93923,5,195380,1.96104389897902,2829
402,"CCA","GCA","P","A",0,101457,1,93923,1,195380,1.5803678252286,2830
402,"CCA","TCA","P","S",3,101457,4,93923,7,195380,0.883454232801811,2831
403,"ATG","AAG","M","K",1,100528,0,93774,1,194302,1.49986242869979,2832
403,"ATG","ACG","M","T",4,100528,3,93774,7,194302,0.858574314007246,2833
403,"ATG","AGG","M","R",1,100528,0,93774,1,194302,1.49986242869979,2834
403,"ATG","ATA","M","I",2,100528,3,93774,5,194302,0.973821978564954,2835
403,"ATG","ATG","M","M",100508,100528,93762,93774,194270,194302,1,2836
403,"ATG","ATT","M","I",8,100528,5,93774,13,194302,1.08454829117573,2837
403,"ATG","GTG","M","V",2,100528,1,93774,3,194302,1.08454829117573,2838
403,"ATG","TTG","M","L",2,100528,0,93774,2,194302,2.17842827989673,2839
404,"AAA","AAA","K","K",99838,99842,93379,93385,193217,193227,1,2840
404,"AAA","AAC","K","N",0,99842,1,93385,1,193227,1.58407846642179,2841
404,"AAA","AAG","K","K",2,99842,2,93385,4,193227,0.628500396943169,2842
404,"AAA","AAT","K","N",0,99842,1,93385,1,193227,1.58407846642179,2843
404,"AAA","ACA","K","T",0,99842,1,93385,1,193227,1.58407846642179,2844
404,"AAA","AGA","K","R",0,99842,1,93385,1,193227,1.58407846642179,2845
404,"AAA","GAA","K","E",2,99842,0,93385,2,193227,2.18303247412323,2846
405,"CTG","ATG","L","M",4,99917,8,95934,12,195851,1.42594136517497,2847
405,"CTG","CCG","L","P",3,99917,6,95934,9,195851,1.38235504925712,2848
405,"CTG","CTA","L","L",2,99917,0,95934,2,195851,2.22958029882384,2849
405,"CTG","CTG","L","L",99900,99917,95913,95934,195813,195851,1,2850
405,"CTG","CTT","L","L",5,99917,4,95934,9,195851,0.844732084767587,2851
405,"CTG","GTG","L","V",1,99917,0,95934,1,195851,1.54481298601999,2852
405,"CTG","TTG","L","L",2,99917,3,95934,5,195851,0.993085657720845,2853
406,"GAG","AAG","E","K",3,98849,3,96957,6,195806,0.674100344378853,2854
406,"GAG","CAG","E","Q",0,98849,2,96957,2,195806,2.29880463779466,2855
406,"GAG","GAA","E","E",6,98849,6,96957,12,195806,0.674100344378853,2856
406,"GAG","GAG","E","E",98802,98849,96920,96957,195722,195806,1,2857
406,"GAG","GAT","E","D",7,98849,10,96957,17,195806,1.04833315256722,2858
406,"GAG","GGG","E","G",20,98849,13,96957,33,195806,1.15218475771953,2859
406,"GAG","GTG","E","V",4,98849,1,96957,5,195806,1.94793204761274,2860
406,"GAG","TAG","E",".",7,98849,2,96957,9,195806,2.05959416102163,2861
407,"GAC","AAC","D","N",4,97684,2,97461,6,195145,1.32591192061879,2862
407,"GAC","CAC","D","H",1,97684,0,97461,1,195145,1.60592967319899,2863
407,"GAC","GAA","D","E",3,97684,4,97461,7,195145,0.93927354576024,2864
407,"GAC","GAC","D","D",97662,97684,97448,97461,195110,195145,1,2865
407,"GAC","GAG","D","E",0,97684,1,97461,1,195145,1.60856200580137,2866
407,"GAC","GAT","D","D",5,97684,2,97461,7,195145,1.60592967319899,2867
407,"GAC","GCC","D","A",1,97684,0,97461,1,195145,1.60592967319899,2868
407,"GAC","GGC","D","G",2,97684,2,97461,4,195145,0.69095597377264,2869
407,"GAC","GTC","D","V",1,97684,0,97461,1,195145,1.60592967319899,2870
407,"GAC","TAC","D","Y",5,97684,2,97461,7,195145,1.60592967319899,2871
408,"GCA","ACA","A","T",47,97318,50,97930,97,195248,0.748919535074356,2872
408,"GCA","CCA","A","P",1,97318,0,97930,1,195248,1.60692039343874,2873
408,"GCA","GAA","A","E",10,97318,5,97930,15,195248,1.46984000655244,2874
408,"GCA","GCA","A","A",97229,97318,97846,97930,195075,195248,1,2875
408,"GCA","GCG","A","A",5,97318,8,97930,13,195248,1.16991337083995,2876
408,"GCA","GCT","A","A",1,97318,1,97930,2,195248,0.686841459467957,2877
408,"GCA","GTA","A","V",17,97318,12,97930,29,195248,1.06629155573754,2878
408,"GCA","TCA","A","S",8,97318,8,97930,16,195248,0.686841459467957,2879
409,"GTG","ATG","V","M",8,97338,7,99747,15,197085,0.796507830470799,2880
409,"GTG","GTA","V","V",8,97338,2,99747,10,197085,2.29778936354487,2881
409,"GTG","GTC","V","V",0,97338,1,99747,1,197085,1.57041223440817,2882
409,"GTG","GTG","V","V",97318,97338,99733,99747,197051,197085,1,2883
409,"GTG","GTT","V","V",3,97338,3,99747,6,197085,0.668935179922073,2884
409,"GTG","TTG","V","L",1,97338,1,99747,2,197085,0.668935179922073,2885
410,"TAC","AAC","Y","N",0,93042,1,100059,1,193101,1.49412056328093,2886
410,"TAC","CAC","Y","H",1,93042,0,100059,1,193101,1.58183115719125,2887
410,"TAC","GAC","Y","D",1,93042,0,100059,1,193101,1.58183115719125,2888
410,"TAC","TAA","Y",".",0,93042,3,100059,3,193101,2.69609004876499,2889
410,"TAC","TAC","Y","Y",92900,93042,99953,100059,192853,193101,1,2890
410,"TAC","TAG","Y",".",4,93042,3,100059,7,193101,0.886389778070935,2891
410,"TAC","TAT","Y","Y",104,93042,99,100059,203,193101,0.67618113933809,2892
410,"TAC","TGC","Y","C",2,93042,0,100059,2,193101,2.28887697896441,2894
411,"GGT","AGT","G","S",4,94434,7,101187,11,195621,1.17262459664927,2895
411,"GGT","GAT","G","D",2,94434,8,101187,10,195621,2.1794521976739,2896
411,"GGT","GGC","G","G",0,94434,3,101187,3,195621,2.70406735370464,2897
411,"GGT","GGG","G","G",0,94434,3,101187,3,195621,2.70406735370464,2898
411,"GGT","GGT","G","G",94421,94434,101156,101187,195577,195621,1,2899
411,"GGT","GTT","G","V",3,94434,5,101187,8,195621,1.0853127031724,2900
411,"GGT","TGT","G","C",4,94434,5,101187,9,195621,0.812987586993111,2901
412,"ACC","AAC","T","N",2,93750,1,99609,3,193359,1.14286866460362,2902
412,"ACC","ACA","T","T",3,93750,4,99609,7,193359,0.868773780152471,2903
412,"ACC","ACC","T","T",93735,93750,99597,99609,193332,193359,1,2904
412,"ACC","ACT","T","T",6,93750,2,99609,8,193359,1.84533109462671,2905
412,"ACC","AGC","T","S",1,93750,1,99609,2,193359,0.634326093137936,2906
412,"ACC","ATC","T","I",3,93750,4,99609,7,193359,0.868773780152471,2907
413,"GAG","AAG","E","K",6,93150,4,98838,10,191988,1.04666178076445,2908
413,"GAG","CAG","E","Q",1,93150,0,98838,1,191988,1.58680931744614,2909
413,"GAG","GAA","E","E",4,93150,0,98838,4,191988,3.25378446812151,2910
413,"GAG","GAC","E","D",1,93150,0,98838,1,191988,1.58680931744614,2911
413,"GAG","GAG","E","E",93119,93150,98810,98838,191929,191988,1,2912
413,"GAG","GAT","E","D",6,93150,7,98838,13,191988,0.770109767783447,2913
413,"GAG","GGG","E","G",0,93150,5,98838,5,191988,3.49567667232468,2914
413,"GAG","GTG","E","V",0,93150,2,98838,2,191988,2.19646295533088,2915
413,"GAG","TAG","E",".",13,93150,10,98838,23,191988,0.919470577836037,2916
414,"GGT","AGT","G","S",4,91367,1,100247,5,191614,1.95736176738207,2917
414,"GGT","GAT","G","D",1,91367,6,100247,7,191614,2.41368991489315,2918
414,"GGT","GGA","G","G",1,91367,0,100247,1,191614,1.57497525312623,2919
414,"GGT","GGC","G","G",0,91367,2,100247,2,191614,2.13719128965405,2920
414,"GGT","GGT","G","G",91348,91367,100230,100247,191578,191614,1,2921
414,"GGT","GTT","G","V",8,91367,3,100247,11,191614,1.77378592069916,2922
414,"GGT","TGT","G","C",5,91367,5,100247,10,191614,0.604655840148014,2923
415,"CTT","ATT","L","I",18,90078,30,98218,48,188296,1.17544493883085,2924
415,"CTT","CAT","L","H",5,90078,2,98218,7,188296,1.57718339543234,2925
415,"CTT","CCT","L","P",2,90078,3,98218,5,188296,0.914547389328944,2926
415,"CTT","CGT","L","R",0,90078,2,98218,2,188296,2.14846666759931,2927
415,"CTT","CTA","L","L",1,90078,0,98218,1,188296,1.57718339543234,2928
415,"CTT","CTC","L","L",9,90078,10,98218,19,188296,0.702093878203939,2929
415,"CTT","CTG","L","L",0,90078,1,98218,1,188296,1.47366452065574,2930
415,"CTT","CTT","L","L",90042,90078,98168,98218,188210,188296,1,2931
415,"CTT","TTT","L","F",1,90078,2,98218,3,188296,1.06226853676937,2932
416,"GAG","AAG","E","K",0,90066,1,100603,1,190669,1.43653891853479,2933
416,"GAG","CAG","E","Q",0,90066,1,100603,1,190669,1.43653891853479,2934
416,"GAG","GAA","E","E",2,90066,1,100603,3,190669,1.11564252216746,2935
416,"GAG","GAG","E","E",90041,90066,100573,100603,190614,190669,1,2936
416,"GAG","GAT","E","D",3,90066,6,100603,9,190669,1.23972988734048,2937
416,"GAG","GCG","E","A",0,90066,1,100603,1,190669,1.43653891853479,2938
416,"GAG","GGG","E","G",6,90066,9,100603,15,190669,0.969176074818185,2939
416,"GAG","GTG","E","V",0,90066,1,100603,1,190669,1.43653891853479,2940
416,"GAG","GTT","E","V",0,90066,1,100603,1,190669,1.43653891853479,2941
416,"GAG","TAG","E",".",14,90066,9,100603,23,190669,1.11564252216746,2942
417,"GCG","ACG","A","T",2,92670,1,100137,3,192807,1.13354075355301,2943
417,"GCG","CCG","A","P",1,92670,0,100137,1,192807,1.58034619936292,2944
417,"GCG","GAG","A","E",15,92670,14,100137,29,192807,0.690350605085748,2945
417,"GCG","GCA","A","A",43,92670,54,100137,97,192807,0.849507616734387,2946
417,"GCG","GCC","A","A",1,92670,1,100137,2,192807,0.618766724652013,2947
417,"GCG","GCG","A","A",92587,92670,100035,100137,192622,192807,1,2948
417,"GCG","GCT","A","A",8,92670,16,100137,24,192807,1.40029484509193,2949
417,"GCG","GGG","A","G",0,92670,1,100137,1,192807,1.48761994371335,2950
417,"GCG","GTG","A","V",11,92670,14,100137,25,192807,0.849507616734387,2951
417,"GCG","TCG","A","S",2,92670,1,100137,3,192807,1.13354075355301,2952
418,"CTT","ATT","L","I",7,90730,9,101209,16,191939,0.813481896985114,2953
418,"CTT","CAT","L","H",6,90730,3,101209,9,191939,1.35226670983989,2954
418,"CTT","CCT","L","P",2,90730,5,101209,7,191939,1.4385823173246,2955
418,"CTT","CGT","L","R",0,90730,1,101209,1,191939,1.4385823173246,2956
418,"CTT","CTA","L","L",0,90730,1,101209,1,191939,1.4385823173246,2957
418,"CTT","CTC","L","L",5,90730,10,101209,15,191939,1.30867189567669,2958
418,"CTT","CTT","L","L",90705,90730,101179,101209,191884,191939,1,2959
418,"CTT","TTT","L","F",5,90730,1,101209,6,191939,2.28275773484368,2960
419,"GAT","AAT","D","N",2,89532,3,102063,5,191595,0.862067530852285,2961
419,"GAT","CAT","D","H",0,89532,1,102063,1,191595,1.40563517232404,2962
419,"GAT","GAC","D","D",1,89532,1,102063,2,191595,0.570713441317998,2963
419,"GAT","GAT","D","D",89521,89532,102050,102063,191571,191595,1,2964
419,"GAT","GGT","D","G",2,89532,0,102063,2,191595,2.27926826185698,2965
419,"GAT","TAT","D","Y",6,89532,8,102063,14,191595,0.820695114763584,2966
420,"CTA","ATA","L","I",9,90760,10,101226,19,191986,0.679420847268661,2967
420,"CTA","CCA","L","P",1,90760,3,101226,4,191986,1.43880438787869,2968
420,"CTA","CTA","L","L",90746,90760,101210,101226,191956,191986,1,2969
420,"CTA","CTG","L","L",1,90760,0,101226,1,191986,1.56943082107304,2970
420,"CTA","GTA","L","V",1,90760,3,101226,4,191986,1.43880438787869,2971
420,"CTA","TTA","L","L",2,90760,0,101226,2,191986,2.28278160489204,2972
421,"ACA","AAA","T","K",6,89981,5,100965,11,190946,0.767958073847841,2973
421,"ACA","ACA","T","T",89969,89981,100952,100965,190921,190946,1,2974
421,"ACA","ACC","T","T",0,89981,1,100965,1,190946,1.42959286315125,2975
421,"ACA","ACG","T","T",0,89981,1,100965,1,190946,1.42959286315125,2976
421,"ACA","ACT","T","T",0,89981,1,100965,1,190946,1.42959286315125,2977
421,"ACA","AGA","T","R",0,89981,1,100965,1,190946,1.42959286315125,2978
421,"ACA","ATA","T","I",6,89981,2,100965,8,190946,1.83077086614788,2979
421,"ACA","GCA","T","A",0,89981,2,100965,2,190946,2.09780269311247,2980
422,"ACG","AAG","T","K",1,89413,3,100192,4,189605,1.43160446158728,2981
422,"ACG","ACA","T","T",2,89413,8,100192,10,189605,2.10012252764377,2982
422,"ACG","ACC","T","T",1,89413,1,100192,2,189605,0.585758099830349,2983
422,"ACG","ACG","T","T",89375,89413,100153,100192,189528,189605,1,2984
422,"ACG","ACT","T","T",12,89413,11,100192,23,189605,0.678014961383107,2985
422,"ACG","AGG","T","R",2,89413,1,100192,3,189605,1.11394490239363,2986
422,"ACG","ATG","T","M",19,89413,14,100192,33,189605,0.945511636923874,2987
422,"ACG","GCG","T","A",0,89413,1,100192,1,189605,1.43160446158728,2988
422,"ACG","TCG","T","S",1,89413,0,100192,1,189605,1.56785568816584,2989
423,"AGT","AAT","S","N",1,89426,1,101655,2,191081,0.573143858464618,2990
423,"AGT","AGA","S","R",1,89426,0,101655,1,191081,1.56314996103845,2991
423,"AGT","AGT","S","S",89421,89426,101652,101655,191073,191081,1,2992
423,"AGT","ATT","S","I",2,89426,2,101655,4,191081,0.573143858464618,2993
423,"AGT","GGT","S","G",1,89426,0,101655,1,191081,1.56314996103845,2994
424,"GCC","ACC","A","T",3,89632,9,102128,12,191760,1.76047382368961,2995
424,"GCC","CCC","A","P",0,89632,1,102128,1,191760,1.40651919221815,2996
424,"GCC","GAC","A","D",6,89632,3,102128,9,191760,1.34362971652514,2997
424,"GCC","GCA","A","A",4,89632,2,102128,6,191760,1.26644283289498,2998
424,"GCC","GCC","A","A",89555,89632,102029,102128,191584,191760,1,2999
424,"GCC","GCG","A","A",1,89632,0,102128,1,191760,1.56243660245884,3000
424,"GCC","GCT","A","A",12,89632,11,102128,23,191760,0.664769233539357,3001
424,"GCC","GGC","A","G",1,89632,2,102128,3,191760,1.00557155789305,3002
424,"GCC","GTC","A","V",42,89632,62,102128,104,191760,0.975985116641156,3003
424,"GCC","TCC","A","S",8,89632,9,102128,17,191760,0.66841846069521,3004
425,"GGT","AGT","G","S",5,90053,18,102197,23,192250,2.17339181355385,3005
425,"GGT","CGT","G","R",1,90053,0,102197,1,192250,1.56373878197788,3006
425,"GGT","GAT","G","D",4,90053,11,102197,15,192250,1.69991556813921,3007
425,"GGT","GGC","G","G",2,90053,1,102197,3,192250,1.10745532098437,3008
425,"GGT","GGT","G","G",90031,90053,102160,102197,192191,192250,1,3009
425,"GGT","GTT","G","V",6,90053,2,102197,8,192250,1.8279453233179,3010
425,"GGT","TGT","G","C",4,90053,5,102197,9,192250,0.750647542918086,3011
426,"TAC","CAC","Y","H",2,90687,0,101744,2,192431,2.28180568165365,3012
426,"TAC","TAA","Y",".",1,90687,0,101744,1,192431,1.56743812666108,3013
426,"TAC","TAC","Y","Y",90677,90687,101740,101744,192417,192431,1,3014
426,"TAC","TAT","Y","Y",6,90687,3,101744,9,192431,1.34985076997586,3015
426,"TAC","TGC","Y","C",1,90687,0,101744,1,192431,1.56743812666108,3016
426,"TAC","TTC","Y","F",0,90687,1,101744,1,192431,1.42968897635567,3017
427,"CCA","ACA","P","T",3,89831,11,103087,14,192918,2.05875750813306,3018
427,"CCA","CAA","P","Q",8,89831,12,103087,20,192918,0.949649841954499,3019
427,"CCA","CCA","P","P",89812,89831,103050,103087,192862,192918,1,3020
427,"CCA","CCG","P","P",3,89831,3,103087,6,192918,0.565075605832348,3021
427,"CCA","CGA","P","R",0,89831,1,103087,1,192918,1.39582956845957,3022
427,"CCA","CTA","P","L",2,89831,3,103087,5,192918,0.854571013258068,3023
427,"CCA","TCA","P","S",3,89831,7,103087,10,192918,1.39582956845957,3024
428,"TAT","AAT","Y","N",0,88032,1,103599,1,191631,1.35791891638944,3025
428,"TAT","CAT","Y","H",5,88032,3,103599,8,191631,1.08924298592211,3026
428,"TAT","GAT","Y","D",1,88032,0,103599,1,191631,1.55223738512244,3027
428,"TAT","TAA","Y",".",0,88032,1,103599,1,191631,1.35791891638944,3028
428,"TAT","TAT","Y","Y",88024,88032,103592,103599,191616,191631,1,3029
428,"TAT","TGT","Y","C",2,88032,1,103599,3,191631,1.08924298592211,3030
428,"TAT","TTT","Y","F",0,88032,1,103599,1,191631,1.35791891638944,3031
429,"GTT","ATT","V","I",1,88268,1,101630,2,189898,0.562205547358767,3032
429,"GTT","GCT","V","A",1,88268,1,101630,2,189898,0.562205547358767,3033
429,"GTT","GGT","V","G",0,88268,2,101630,2,189898,2.05294888652708,3034
429,"GTT","GTC","V","V",0,88268,7,101630,7,189898,3.89772992353325,3035
429,"GTT","GTT","V","V",88266,88268,101614,101630,189880,189898,1,3036
429,"GTT","TTT","V","F",0,88268,5,101630,5,189898,3.33802206576682,3037
430,"GCA","ACA","A","T",15,89959,24,101161,39,191120,1.07525305684282,3038
430,"GCA","CCA","A","P",0,89959,1,101161,1,191120,1.42631170914005,3039
430,"GCA","GAA","A","E",8,89959,3,101161,11,191120,1.76701053023708,3040
430,"GCA","GCA","A","A",89920,89959,101115,101161,191035,191120,1,3041
430,"GCA","GCC","A","A",0,89959,1,101161,1,191120,1.42631170914005,3042
430,"GCA","GCG","A","A",0,89959,1,101161,1,191120,1.42631170914005,3043
430,"GCA","GTA","A","V",3,89959,8,101161,11,191120,1.610151848256,3044
430,"GCA","TCA","A","S",13,89959,8,101161,21,191120,1.16645220319668,3045
431,"CTG","ATG","L","M",2,90509,3,102168,5,192677,0.873471877299444,3046
431,"CTG","CAG","L","Q",2,90509,0,102168,2,192677,2.28083086929565,3047
431,"CTG","CCG","L","P",1,90509,0,102168,1,192677,1.56544567480448,3048
431,"CTG","CGG","L","R",1,90509,0,102168,1,192677,1.56544567480448,3049
431,"CTG","CTA","L","L",2,90509,2,102168,4,192677,0.579310246168456,3050
431,"CTG","CTC","L","L",0,90509,1,102168,1,192677,1.42050922808303,3051
431,"CTG","CTG","L","L",90493,90509,102149,102168,192642,192677,1,3052
431,"CTG","CTT","L","L",6,90509,8,102168,14,192677,0.831749277742662,3053
431,"CTG","TTG","L","L",2,90509,5,102168,7,192677,1.42050922808303,3054
432,"GGT","AGT","G","S",2,89781,7,101891,9,191672,1.87494363368577,3055
432,"GGT","CGT","G","R",1,89781,1,101891,2,191672,0.574540150892711,3056
432,"GGT","GAT","G","D",8,89781,4,101891,12,191672,1.39036444281275,3057
432,"GGT","GCT","G","A",2,89781,0,101891,2,191672,2.27996247054189,3058
432,"GGT","GGA","G","G",0,89781,1,101891,1,191672,1.41226761957316,3059
432,"GGT","GGC","G","G",5,89781,4,101891,9,191672,0.795845231304742,3060
432,"GGT","GGT","G","G",89750,89781,101863,101891,191613,191672,1,3061
432,"GGT","GTT","G","V",4,89781,3,101891,7,191672,0.849643750731813,3062
432,"GGT","TGT","G","C",9,89781,8,101891,17,191672,0.69857313547147,3063
433,"ATC","ACC","I","T",1,88270,1,100644,2,188914,0.570543847632256,3064
433,"ATC","ATA","I","I",4,88270,7,100644,11,188914,1.08830137709211,3065
433,"ATC","ATC","I","I",88259,88270,100631,100644,188890,188914,1,3066
433,"ATC","ATG","I","M",1,88270,1,100644,2,188914,0.570543847632256,3067
433,"ATC","ATT","I","I",4,88270,3,100644,7,188914,0.846610044251905,3068
433,"ATC","GTC","I","V",1,88270,1,100644,2,188914,0.570543847632256,3069
434,"AAG","AAA","K","K",1,87852,1,99840,2,187692,0.573425372700418,3070
434,"AAG","AAG","K","K",87836,87852,99818,99840,187654,187692,1,3071
434,"AAG","AAT","K","N",6,87852,8,99840,14,187692,0.824185174965561,3072
434,"AAG","AGG","K","R",0,87852,3,99840,3,187692,2.59445965745999,3073
434,"AAG","ATG","K","M",1,87852,1,99840,2,187692,0.573425372700418,3074
434,"AAG","CAG","K","Q",0,87852,1,99840,1,187692,1.41033740734347,3075
434,"AAG","GAG","K","E",6,87852,8,99840,14,187692,0.824185174965561,3076
434,"AAG","TAG","K",".",2,87852,0,99840,2,187692,2.27976001257305,3077
435,"AAG","AAA","K","K",2,88628,3,101364,5,189992,0.858272589236453,3078
435,"AAG","AAC","K","N",0,88628,1,101364,1,189992,1.40067413815003,3079
435,"AAG","AAG","K","K",88615,88628,101350,101364,189965,189992,1,3080
435,"AAG","AAT","K","N",7,88628,8,101364,15,189992,0.676788929182443,3081
435,"AAG","AGG","K","R",1,88628,1,101364,2,189992,0.567858105592602,3082
435,"AAG","GAG","K","E",3,88628,0,101364,3,189992,2.81926258095782,3083
435,"AAG","TAG","K",".",0,88628,1,101364,1,189992,1.40067413815003,3084
436,"AGG","AGA","R","R",2,86568,3,100205,5,186773,0.844444003994987,3085
436,"AGG","AGG","R","R",86546,86568,100185,100205,186731,186773,1,3086
436,"AGG","AGT","R","S",8,86568,4,100205,12,186773,1.38285336097108,3087
436,"AGG","ATG","R","M",6,86568,5,100205,11,186773,0.745441087230081,3088
436,"AGG","CGG","R","R",0,86568,1,100205,1,186773,1.38254700176119,3089
436,"AGG","GGG","R","G",5,86568,7,100205,12,186773,0.844444003994987,3090
436,"AGG","TGG","R","W",1,86568,0,100205,1,186773,1.55735686642645,3091
437,"GAC","AAC","D","N",1,86713,5,98210,6,184923,2.0812638376803,3092
437,"GAC","GAA","D","E",4,86713,2,98210,6,184923,1.26896721087967,3093
437,"GAC","GAC","D","D",86682,86713,98186,98210,184868,184923,1,3094
437,"GAC","GAG","D","E",0,86713,1,98210,1,184923,1.41526956906099,3095
437,"GAC","GAT","D","D",2,86713,0,98210,2,184923,2.28027803770457,3096
437,"GAC","GGC","D","G",8,86713,4,98210,12,184923,1.39113240718747,3097
437,"GAC","GTC","D","V",1,86713,0,98210,1,184923,1.56431482170416,3098
437,"GAC","TAC","D","Y",15,86713,12,98210,27,184923,0.830380699880876,3099
438,"ATC","ACC","I","T",2,89952,3,98508,5,188460,0.909262157620935,3100
438,"ATC","ATA","I","I",4,89952,7,98508,11,188460,1.1425608611501,3101
438,"ATC","ATC","I","I",89941,89952,98492,98508,188433,188460,1,3102
438,"ATC","ATG","I","M",0,89952,2,98508,2,188460,2.14066674673038,3103
438,"ATC","ATT","I","I",5,89952,3,98508,8,188460,1.12619526361255,3104
438,"ATC","CTC","I","L",0,89952,1,98508,1,188460,1.46686067433148,3105
439,"CTC","ATC","L","I",8,91311,9,97739,17,189050,0.731231320752946,3106
439,"CTC","CCC","L","P",2,91311,4,97739,6,189050,1.2310091638652,3107
439,"CTC","CTA","L","L",13,91311,11,97739,24,189050,0.803792492403748,3108
439,"CTC","CTC","L","L",91286,91311,97707,97739,188993,189050,1,3109
439,"CTC","CTT","L","L",0,91311,2,97739,2,189050,2.1810924522991,3110
439,"CTC","GTC","L","V",1,91311,1,97739,2,189050,0.62748065796124,3111
439,"CTC","TTC","L","F",1,91311,5,97739,6,189050,2.1810924522991,3112
440,"TCT","CCT","S","P",0,91649,1,96798,1,188447,1.52294487214426,3113
440,"TCT","TAT","S","Y",13,91649,11,96798,24,188447,0.814275071885093,3114
440,"TCT","TCA","S","S",0,91649,1,96798,1,188447,1.52294487214426,3115
440,"TCT","TCC","S","S",2,91649,3,96798,5,188447,0.953065663210506,3116
440,"TCT","TCT","S","S",91633,91649,96782,96798,188415,188447,1,3117
440,"TCT","TTT","S","F",1,91649,0,96798,1,188447,1.58850584016516,3118
441,"AAG","AAA","K","K",2,90363,2,95676,4,186039,0.637587793124186,3119
441,"AAG","AAC","K","N",1,90363,0,95676,1,186039,1.58758316537676,3120
441,"AAG","AAG","K","K",90347,90363,95665,95676,186012,186039,1,3121
441,"AAG","AAT","K","N",10,90363,7,95676,17,186039,1.023362989425,3122
441,"AAG","AGG","K","R",0,90363,2,95676,2,186039,2.20024281719606,3123
441,"AAG","GAG","K","E",2,90363,0,95676,2,186039,2.29171742202335,3124
441,"AAG","TAG","K",".",1,90363,0,95676,1,186039,1.58758316537676,3125
442,"AAG","AAG","K","K",91892,91904,95519,95536,187411,187440,1,3126
442,"AAG","AAT","K","N",11,91904,14,95536,25,187440,0.894492104942709,3127
442,"AAG","GAG","K","E",0,91904,3,95536,3,187440,2.76051572987154,3128
442,"AAG","TAG","K",".",1,91904,0,95536,1,187440,1.59442570984475,3129
443,"ACT","AAT","T","N",5,92827,2,94262,7,187089,1.6033802126245,3130
443,"ACT","ACA","T","T",0,92827,1,94262,1,187089,1.58498377675726,3131
443,"ACT","ACC","T","T",2,92827,4,94262,6,187089,1.30668210008406,3132
443,"ACT","ACG","T","T",0,92827,1,94262,1,187089,1.58498377675726,3133
443,"ACT","ACT","T","T",92819,92827,94253,94262,187072,187089,1,3134
443,"ACT","AGT","T","S",0,92827,1,94262,1,187089,1.58498377675726,3135
443,"ACT","ATT","T","I",1,92827,0,94262,1,187089,1.6033802126245,3136
444,"AAG","AAA","K","K",2,92891,1,94078,3,186969,1.17089439687616,3137
444,"AAG","AAC","K","N",2,92891,0,94078,2,186969,2.30006949831463,3138
444,"AAG","AAG","K","K",92861,92891,94050,94078,186911,186969,1,3139
444,"AAG","AAT","K","N",5,92891,7,94078,12,186969,1.00544099584338,3140
444,"AAG","ACG","K","T",3,92891,2,94078,5,186969,1.01256533576337,3141
444,"AAG","AGG","K","R",13,92891,10,94078,23,186969,0.953474902881449,3142
444,"AAG","ATG","K","M",2,92891,7,94078,9,186969,2.07096183954519,3143
444,"AAG","CAG","K","Q",1,92891,0,94078,1,186969,1.60440037889593,3144
444,"AAG","GAG","K","E",0,92891,1,94078,1,186969,1.58913370427036,3145
444,"AAG","TAG","K",".",2,92891,0,94078,2,186969,2.30006949831463,3146
445,"GAC","AAC","D","N",0,96266,2,95098,2,191364,2.30017189951535,3147
445,"GAC","GAA","D","E",6,96266,1,95098,7,191364,2.56146175990767,3148
445,"GAC","GAC","D","D",96247,96266,95080,95098,191327,191364,1,3149
445,"GAC","GAG","D","E",1,96266,0,95098,1,191364,1.58996731201512,3150
445,"GAC","GAT","D","D",1,96266,3,95098,4,191364,1.60460568788386,3151
445,"GAC","GGC","D","G",1,96266,0,95098,1,191364,1.58996731201512,3152
445,"GAC","TAC","D","Y",10,96266,12,95098,22,191364,0.863982764646473,3153
446,"CTA","AAA","L","K",0,98108,2,94696,2,192804,2.29573134072896,3154
446,"CTA","ATA","L","I",10,98108,7,94696,17,192804,1.01577012979473,3155
446,"CTA","CAA","L","Q",1,98108,1,94696,2,192804,0.658398793500618,3156
446,"CTA","CCA","L","P",10,98108,9,94696,19,192804,0.754878550485417,3157
446,"CTA","CTA","L","L",98084,98108,94675,94696,192759,192804,1,3158
446,"CTA","CTC","L","L",0,98108,1,94696,1,192804,1.59568310962671,3159
446,"CTA","GTA","L","V",1,98108,0,94696,1,192804,1.55324574236872,3160
446,"CTA","TTA","L","L",2,98108,1,94696,3,192804,1.13021360724128,3161
447,"ACA","AAA","T","K",4,97706,4,94357,8,192063,0.658876366402012,3162
447,"ACA","ACA","T","T",97701,97706,94352,94357,192053,192063,1,3163
447,"ACA","ATA","T","I",1,97706,0,94357,1,192063,1.55402630323743,3164
447,"ACA","TCA","T","S",0,97706,1,94357,1,192063,1.59587019737629,3165
448,"AAG","AAA","K","K",1,100372,1,92744,2,193116,0.617261787933683,3166
448,"AAG","AAG","K","K",100364,100372,92740,92744,193104,193116,1,3167
448,"AAG","AAT","K","N",4,100372,2,92744,6,193116,1.2154441438946,3168
448,"AAG","AGG","K","R",2,100372,0,92744,2,193116,2.16155177828629,3169
448,"AAG","ATG","K","M",1,100372,1,92744,2,193116,0.617261787933683,3170
449,"TTA","AAA","L","K",0,99805,1,92257,1,192062,1.57989060210733,3171
449,"TTA","CTA","L","L",1,99805,0,92257,1,192062,1.48561894364686,3172
449,"TTA","GTA","L","V",2,99805,0,92257,2,192062,2.16215250928504,3173
449,"TTA","TAA","L",".",0,99805,3,92257,3,192062,2.82461321688749,3174
449,"TTA","TTA","L","L",99802,99805,92252,92257,192054,192062,1,3175
449,"TTA","TTG","L","L",0,99805,1,92257,1,192062,1.57989060210733,3176
450,"AAG","AAA","K","K",2,101841,3,91165,5,193006,0.947450790233453,3177
450,"AAG","AAC","K","N",1,101841,0,91165,1,193006,1.43636823399727,3178
450,"AAG","AAG","K","K",101822,101841,91149,91165,192971,193006,1,3179
450,"AAG","AAT","K","N",2,101841,1,91165,3,193006,1.03070265499829,3180
450,"AAG","ACG","K","T",4,101841,1,91165,5,193006,1.79316344118281,3181
450,"AAG","AGG","K","R",6,101841,5,91165,11,193006,0.737510752599167,3182
450,"AAG","ATG","K","M",3,101841,5,91165,8,193006,1.11558370915425,3183
450,"AAG","GAG","K","E",1,101841,1,91165,2,193006,0.588535695234063,3184
451,"GAA","AAA","E","K",3,102417,1,91182,4,193599,1.42821243652447,3185
451,"GAA","CAA","E","Q",1,102417,0,91182,1,193599,1.42821243652447,3186
451,"GAA","GAA","E","E",102397,102417,91174,91182,193571,193599,1,3187
451,"GAA","GAC","E","D",3,102417,0,91182,3,193599,2.6162963013208,3188
451,"GAA","GAG","E","E",0,102417,1,91182,1,193599,1.56711667868744,3189
451,"GAA","GAT","E","D",0,102417,1,91182,1,193599,1.56711667868744,3190
451,"GAA","GGA","E","G",1,102417,0,91182,1,193599,1.42821243652447,3191
451,"GAA","TAA","E",".",12,102417,5,91182,17,193599,1.55218966137438,3192
452,"TGT","TAT","C","Y",1,104924,3,92419,4,197343,1.56354610405651,3193
452,"TGT","TGA","C",".",1,104924,3,92419,4,197343,1.56354610405651,3194
452,"TGT","TGC","C","C",2,104924,3,92419,5,197343,0.937466633200548,3195
452,"TGT","TGT","C","C",104916,104924,92405,92419,197321,197343,1,3196
452,"TGT","TTT","C","F",4,104924,5,92419,9,197343,0.795580330129293,3197
453,"ATG","AAG","M","K",1,104989,0,91258,1,196247,1.39185146786697,3198
453,"ATG","ATA","M","I",1,104989,2,91258,3,196247,1.10046809097011,3199
453,"ATG","ATG","M","M",104975,104989,91248,91258,196223,196247,1,3200
453,"ATG","ATT","M","I",9,104989,3,91258,12,196247,1.74437582056822,3201
453,"ATG","GTG","M","V",3,104989,5,91258,8,196247,1.10046809097011,3202
454,"GAC","AAC","D","N",3,106959,4,91845,7,198804,0.832788275871013,3203
454,"GAC","CAC","D","H",1,106959,0,91845,1,198804,1.37343408972553,3204
454,"GAC","GAA","D","E",5,106959,7,91845,12,198804,0.922272742448046,3205
454,"GAC","GAC","D","D",106935,106959,91816,91845,198751,198804,1,3206
454,"GAC","GAT","D","D",0,106959,4,91845,4,198804,3.24793827359901,3207
454,"GAC","GCC","D","A",0,106959,1,91845,1,198804,1.55545090241775,3208
454,"GAC","GGC","D","G",4,106959,5,91845,9,198804,0.778049783731998,3209
454,"GAC","TAC","D","Y",10,106959,8,91845,18,198804,0.742547800891783,3210
454,"GAC","TAT","D","Y",1,106959,0,91845,1,198804,1.37343408972553,3211
455,"AAG","AAA","K","K",8,106748,4,89883,12,196631,1.1930419928868,3212
455,"AAG","AAC","K","N",1,106748,0,89883,1,196631,1.34440946567232,3213
455,"AAG","AAG","K","K",106727,106748,89865,89883,196592,196631,1,3214
455,"AAG","AAT","K","N",6,106748,3,89883,9,196631,1.15412637790842,3215
455,"AAG","ACG","K","T",0,106748,1,89883,1,196631,1.54947135744955,3216
455,"AAG","AGG","K","R",3,106748,4,89883,7,196631,0.820431670630725,3217
455,"AAG","ATG","K","M",0,106748,1,89883,1,196631,1.54947135744955,3218
455,"AAG","CAG","K","Q",0,106748,1,89883,1,196631,1.54947135744955,3219
455,"AAG","GAG","K","E",3,106748,3,89883,6,196631,0.535896793300522,3220
455,"AAG","TAG","K",".",0,106748,1,89883,1,196631,1.54947135744955,3221
456,"TAT","AAT","Y","N",1,105614,1,91407,2,197021,0.559004672272344,3222
456,"TAT","CAT","Y","H",5,105614,9,91407,14,197021,1.26036504281794,3223
456,"TAT","TAT","Y","Y",105607,105614,91393,91407,197000,197021,1,3224
456,"TAT","TGT","Y","C",1,105614,4,91407,5,197021,1.94575740514807,3225
457,"GGC","AGC","G","S",4,106018,4,91280,8,197298,0.55468362842684,3226
457,"GGC","CGC","G","R",1,106018,0,91280,1,197298,1.37764705200982,3227
457,"GGC","GAC","G","D",26,106018,18,91280,44,197298,0.915152454476785,3228
457,"GGC","GGA","G","G",7,106018,9,91280,16,197298,0.834598986194817,3229
457,"GGC","GGC","G","G",105936,106018,91215,91280,197151,197298,1,3230
457,"GGC","GGT","G","G",21,106018,16,91280,37,197298,0.80720586709161,3231
457,"GGC","GTC","G","V",17,106018,16,91280,33,197298,0.604959303104501,3232
457,"GGC","TGC","G","C",6,106018,2,91280,8,197298,1.6167027615142,3233
458,"CTG","ATG","L","M",6,105563,9,92020,15,197583,1.02973831654158,3234
458,"CTG","CAG","L","Q",6,105563,3,92020,9,197583,1.20177628052202,3235
458,"CTG","CCG","L","P",23,105563,35,92020,58,197583,1.10177947166855,3236
458,"CTG","CGG","L","R",2,105563,1,92020,3,197583,0.99654721699484,3237
458,"CTG","CTA","L","L",4,105563,15,92020,19,197583,2.39785132742108,3238
458,"CTG","CTG","L","L",105503,105563,91946,92020,197449,197583,1,3239
458,"CTG","CTT","L","L",16,105563,8,92020,24,197583,1.31099960001841,3240
458,"CTG","GTG","L","V",0,105563,1,92020,1,197583,1.56014611087463,3241
458,"CTG","TTG","L","L",3,105563,2,92020,5,197583,0.854522451663514,3242
459,"AAC","AAA","N","K",2,106834,2,91288,4,198122,0.548265048869742,3243
459,"AAC","AAC","N","N",106823,106834,91285,91288,198108,198122,1,3244
459,"AAC","AAT","N","N",7,106834,0,91288,7,198122,3.86568384016706,3245
459,"AAC","GAC","N","D",1,106834,1,91288,2,198122,0.548265048869742,3246
459,"AAC","TAC","N","Y",1,106834,0,91288,1,198122,1.36634520907381,3247
460,"CTA","ATA","L","I",8,106029,10,90162,18,196191,0.796138300196911,3248
460,"CTA","CAA","L","Q",0,106029,1,90162,1,196191,1.55247297943318,3249
460,"CTA","CCA","L","P",9,106029,3,90162,12,196191,1.70830536007639,3250
460,"CTA","CTA","L","L",106010,106029,90148,90162,196158,196191,1,3251
460,"CTA","CTG","L","L",1,106029,0,90162,1,196191,1.35906289776032,3252
460,"CTA","TTA","L","L",1,106029,0,90162,1,196191,1.35906289776032,3253
461,"CCA","ACA","P","T",2,105491,2,90601,4,196092,0.552460022220596,3254
461,"CCA","CAA","P","Q",2,105491,8,90601,10,196092,2.2759866815594,3255
461,"CCA","CCA","P","P",105481,105491,90586,90601,196067,196092,1,3256
461,"CCA","CCG","P","P",0,105491,1,90601,1,196092,1.55551423692646,3257
461,"CCA","CCT","P","P",2,105491,0,90601,2,196092,2.03309637576191,3258
461,"CCA","CTA","P","L",2,105491,3,90601,5,196092,0.922392035194024,3259
461,"CCA","TCA","P","S",2,105491,1,90601,3,196092,0.978109837104981,3260
462,"ATG","AAG","M","K",0,106145,1,89720,1,195865,1.55060370555997,3261
462,"ATG","ACG","M","T",1,106145,3,89720,4,195865,1.55060370555997,3262
462,"ATG","ATA","M","I",2,106145,2,89720,4,195865,0.53901380679661,3263
462,"ATG","ATC","M","I",2,106145,0,89720,2,195865,2.00536951255471,3264
462,"ATG","ATG","M","M",106136,106145,89703,89720,195839,195865,1,3265
462,"ATG","ATT","M","I",4,106145,4,89720,8,195865,0.53901380679661,3266
462,"ATG","CTG","M","L",0,106145,5,89720,5,195865,3.60316674391181,3267
462,"ATG","GTG","M","V",0,106145,2,89720,2,195865,2.27360061015384,3268
463,"GTG","ATG","V","M",3,106409,2,91461,5,197870,0.838794899378968,3269
463,"GTG","CTG","V","L",0,106409,1,91461,1,197870,1.5558023352709,3270
463,"GTG","GCG","V","A",0,106409,1,91461,1,197870,1.5558023352709,3271
463,"GTG","GTA","V","V",3,106409,1,91461,4,197870,1.37511932897579,3272
463,"GTG","GTC","V","V",1,106409,0,91461,1,197870,1.37511932897579,3273
463,"GTG","GTG","V","V",106384,106409,91446,91461,197830,197870,1,3274
463,"GTG","GTT","V","V",11,106409,8,91461,19,197870,0.838794899378968,3275
463,"GTG","TTG","V","L",7,106409,2,91461,9,197870,1.83327063601654,3276
464,"ACT","AAT","T","N",3,107371,4,92430,7,199801,0.834435903563479,3277
464,"ACT","ACA","T","T",0,107371,2,92430,2,199801,2.27634524750256,3278
464,"ACT","ACG","T","T",1,107371,0,92430,1,199801,1.37726802355672,3279
464,"ACT","ACT","T","T",107365,107371,92422,92430,199787,199801,1,3280
464,"ACT","AGT","T","S",0,107371,1,92430,1,199801,1.55625109541682,3281
464,"ACT","ATT","T","I",1,107371,0,92430,1,199801,1.37726802355672,3282
464,"ACT","GCT","T","A",1,107371,1,92430,2,199801,0.554467861515219,3283
465,"TAT","CAT","Y","H",4,106894,1,92839,5,199733,1.74303648622092,3284
465,"TAT","GAT","Y","D",2,106894,0,92839,2,199733,2.05272843406806,3285
465,"TAT","TAA","Y",".",0,106894,2,92839,2,199733,2.27771304606671,3286
465,"TAT","TAC","Y","Y",1,106894,0,92839,1,199733,1.3906320787311,3287
465,"TAT","TAT","Y","Y",106884,106894,92832,92839,199716,199733,1,3288
465,"TAT","TCT","Y","S",0,106894,1,92839,1,199733,1.5590593867025,3289
465,"TAT","TGT","Y","C",3,106894,3,92839,6,199733,0.562096787210444,3290
466,"GTA","AAA","V","K",0,107049,2,92556,2,199605,2.27700111919899,3291
466,"GTA","ACA","V","T",0,107049,1,92556,1,199605,1.55759820114172,3292
466,"GTA","ATA","V","I",6,107049,2,92556,8,199605,1.62318424618191,3293
466,"GTA","GAA","V","E",0,107049,5,92556,5,199605,3.60406761714381,3294
466,"GTA","GCA","V","A",1,107049,0,92556,1,199605,1.38369621754611,3295
466,"GTA","GTA","V","V",107038,107049,92537,92556,199575,199605,1,3296
466,"GTA","GTG","V","V",1,107049,1,92556,2,199605,0.558131961140209,3297
466,"GTA","TTA","V","L",3,107049,8,92556,11,199605,1.75956425897176,3298
467,"AAA","AAA","K","K",106206,106214,91920,91925,198126,198139,1,3299
467,"AAA","AAG","K","K",2,106214,3,91925,5,198139,0.926973129847653,3300
467,"AAA","AAT","K","N",3,106214,0,91925,3,198139,2.56380577270144,3301
467,"AAA","AGA","K","R",1,106214,0,91925,1,198139,1.38536529814256,3302
467,"AAA","CAA","K","Q",1,106214,0,91925,1,198139,1.38536529814256,3303
467,"AAA","GAA","K","E",1,106214,2,91925,3,198139,1.09830269690554,3304
468,"GAT","AAT","D","N",1,105193,3,93260,4,198453,1.56571160895943,3305
468,"GAT","GAC","D","D",2,105193,1,93260,3,198453,1.0183702996867,3306
468,"GAT","GAG","D","E",1,105193,0,93260,1,198453,1.42173827948094,3307
468,"GAT","GAT","D","D",105177,105193,93251,93260,198428,198453,1,3308
468,"GAT","GGT","D","G",1,105193,1,93260,2,198453,0.580023017554407,3309
468,"GAT","TAT","D","Y",11,105193,4,93260,15,198453,1.70979319135294,3310
469,"GAG","AAG","E","K",2,103852,4,93498,6,197350,1.27764174961886,3311
469,"GAG","GAA","E","E",2,103852,5,93498,7,197350,1.57077819600633,3312
469,"GAG","GAC","E","D",0,103852,1,93498,1,197350,1.57077819600633,3313
469,"GAG","GAG","E","E",103814,103852,93455,93498,197269,197350,1,3314
469,"GAG","GAT","E","D",16,103852,18,93498,34,197350,0.722475428121248,3315
469,"GAG","GCG","E","A",1,103852,1,93498,2,197350,0.593542382273235,3316
469,"GAG","GGG","E","G",8,103852,8,93498,16,197350,0.593542382273235,3317
469,"GAG","GTG","E","V",3,103852,0,93498,3,197350,2.63664317675782,3318
469,"GAG","TAG","E",".",6,103852,6,93498,12,197350,0.593542382273235,3319
470,"CTC","ATC","L","I",13,103044,19,94174,32,197218,1.05635511448251,3320
470,"CTC","CCC","L","P",4,103044,4,94174,8,197218,0.607073538654593,3321
470,"CTC","CGC","L","R",0,103044,1,94174,1,197218,1.5758921568985,3322
470,"CTC","CTA","L","L",14,103044,16,94174,30,197218,0.751179157356497,3323
470,"CTC","CTC","L","L",103007,103044,94129,94174,197136,197218,1,3324
470,"CTC","CTG","L","L",0,103044,1,94174,1,197218,1.5758921568985,3325
470,"CTC","CTT","L","L",4,103044,1,94174,5,197218,1.82762250907323,3326
470,"CTC","GTC","L","V",0,103044,1,94174,1,197218,1.5758921568985,3327
470,"CTC","TTC","L","F",2,103044,2,94174,4,197218,0.607073538654593,3328
471,"AGG","AAG","R","K",2,103469,3,95226,5,198695,0.965039900164491,3329
471,"AGG","ACG","R","T",0,103469,1,95226,1,198695,1.57838360218827,3330
471,"AGG","AGA","R","R",2,103469,1,95226,3,198695,1.06678027438469,3331
471,"AGG","AGC","R","S",0,103469,1,95226,1,198695,1.57838360218827,3332
471,"AGG","AGG","R","R",103426,103469,95192,95226,198618,198695,1,3333
471,"AGG","AGT","R","S",4,103469,1,95226,5,198695,1.83967088455905,3334
471,"AGG","ATG","R","M",13,103469,8,95226,21,198695,1.11507870100006,3335
471,"AGG","CGG","R","R",1,103469,0,95226,1,198695,1.47897801302268,3336
471,"AGG","GGG","R","G",18,103469,14,95226,32,198695,0.858300676878619,3337
471,"AGG","TGG","R","W",3,103469,5,95226,8,198695,1.13047090716633,3338
472,"TCC","ACC","S","T",0,102280,1,95222,1,197502,1.5824223336127,3339
472,"TCC","CCC","S","P",2,102280,2,95222,4,197502,0.624188445512238,3340
472,"TCC","TAC","S","Y",19,102280,20,95222,39,197502,0.677642800992636,3341
472,"TCC","TCA","S","S",4,102280,4,95222,8,197502,0.624188445512238,3342
472,"TCC","TCC","S","S",102250,102280,95193,95222,197443,197502,1,3343
472,"TCC","TCT","S","S",2,102280,1,95222,3,197502,1.08185377103238,3344
472,"TCC","TGC","S","C",3,102280,1,95222,4,197502,1.49669948153305,3345
473,"ATA","AAA","I","K",0,101616,1,93731,1,195347,1.57914356234667,3346
473,"ATA","ACA","I","T",3,101616,1,93731,4,195347,1.48233120800769,3347
473,"ATA","AGA","I","R",2,101616,0,93731,2,195347,2.15839095406797,3348
473,"ATA","ATA","I","I",101607,101616,93721,93731,195328,195347,1,3349
473,"ATA","ATG","I","M",4,101616,5,93731,9,195347,0.828900937528017,3350
473,"ATA","ATT","I","I",0,101616,1,93731,1,195347,1.57914356234667,3351
473,"ATA","GTA","I","V",0,101616,1,93731,1,195347,1.57914356234667,3352
473,"ATA","TTA","I","L",0,101616,1,93731,1,195347,1.57914356234667,3353
474,"GAG","AAG","E","K",0,101939,1,94706,1,196645,1.58165846327163,3354
474,"GAG","GAA","E","E",3,101939,1,94706,4,196645,1.49336624340076,3355
474,"GAG","GAG","E","E",101922,101939,94684,94706,196606,196645,1,3356
474,"GAG","GAT","E","D",4,101939,10,94706,14,196645,1.7409948521901,3357
474,"GAG","GGG","E","G",1,101939,2,94706,3,196645,1.13559147147062,3358
474,"GAG","GTG","E","V",0,101939,1,94706,1,196645,1.58165846327163,3359
474,"GAG","TAG","E",".",9,101939,7,94706,16,196645,0.853759699453638,3360
475,"AAG","AAA","K","K",1,102547,0,95980,1,198527,1.50495568023658,3361
475,"AAG","AAC","K","N",0,102547,1,95980,1,198527,1.58432285372498,3362
475,"AAG","AAG","K","K",102532,102547,95964,95980,198496,198527,1,3363
475,"AAG","AAT","K","N",8,102547,10,95980,18,198527,0.862812172972725,3364
475,"AAG","ACG","K","T",0,102547,2,95980,2,198527,2.2901064073391,3365
475,"AAG","AGG","K","R",3,102547,1,95980,4,198527,1.50495568023658,3366
475,"AAG","ATG","K","M",0,102547,1,95980,1,198527,1.58432285372498,3367
475,"AAG","GAG","K","E",3,102547,1,95980,4,198527,1.50495568023658,3368
476,"GTA","ATA","V","I",2,101135,2,96949,4,198084,0.651852348145946,3369
476,"GTA","GCA","V","A",3,101135,2,96949,5,198084,0.968481577156189,3370
476,"GTA","GTA","V","V",101120,101135,96943,96949,198063,198084,1,3371
476,"GTA","GTC","V","V",1,101135,0,96949,1,198084,1.54252205318552,3372
476,"GTA","GTG","V","V",5,101135,1,96949,6,198084,2.22698091050797,3373
476,"GTA","GTT","V","V",1,101135,0,96949,1,198084,1.54252205318552,3374
476,"GTA","TTA","V","L",3,101135,1,96949,4,198084,1.54252205318552,3375
477,"GCG","ACG","A","T",2,101436,2,97474,4,198910,0.653935856156949,3376
477,"GCG","GAG","A","E",6,101436,14,97474,20,198910,1.70745927060606,3377
477,"GCG","GCA","A","A",2,101436,3,97474,5,198910,0.993574963826086,3378
477,"GCG","GCG","A","A",101397,101436,97420,97474,198817,198910,1,3379
477,"GCG","GCT","A","A",9,101436,12,97474,21,198910,0.960535334309074,3380
477,"GCG","GGG","A","G",0,101436,2,97474,2,198910,2.29486486643227,3381
477,"GCG","GTG","A","V",10,101436,12,97474,22,198910,0.841476316604372,3382
477,"GCG","TCG","A","S",10,101436,9,97474,19,198910,0.749973975718573,3383
478,"AAA","AAA","K","K",102145,102149,96969,96975,199114,199124,1,3384
478,"AAA","AAG","K","K",1,102149,2,96975,3,199124,1.14779049677093,3385
478,"AAA","AAT","K","N",1,102149,3,96975,4,199124,1.58948467921602,3386
478,"AAA","ACA","K","T",1,102149,0,96975,1,199124,1.52711884799583,3387
478,"AAA","ATA","K","I",1,102149,0,96975,1,199124,1.52711884799583,3388
478,"AAA","GAA","K","E",0,102149,1,96975,1,199124,1.58948467921602,3389
479,"GGA","AGA","G","R",1,101958,0,97813,1,199771,1.54349036060552,3390
479,"GGA","GAA","G","E",1,101958,3,97813,4,199771,1.59335425200248,3391
479,"GGA","GCA","G","A",1,101958,0,97813,1,199771,1.54349036060552,3392
479,"GGA","GGA","G","G",101948,101958,97797,97813,199745,199771,1,3393
479,"GGA","GGG","G","G",2,101958,1,97813,3,199771,1.12184241724635,3394
479,"GGA","GTA","G","V",4,101958,8,97813,12,199771,1.42556914851163,3395
479,"GGA","TGA","G",".",1,101958,4,97813,5,199771,1.96993702858436,3396
480,"AAG","AAA","K","K",1,100596,0,97317,1,197913,1.5568011732098,3397
480,"AAG","AAG","K","K",100589,100596,97312,97317,197901,197913,1,3398
480,"AAG","AAT","K","N",3,100596,1,97317,4,197913,1.5568011732098,3399
480,"AAG","ACG","K","T",0,100596,1,97317,1,197913,1.59653618804202,3400
480,"AAG","AGG","K","R",0,100596,1,97317,1,197913,1.59653618804202,3401
480,"AAG","ATG","K","M",1,100596,0,97317,1,197913,1.5568011732098,3402
480,"AAG","CAG","K","Q",0,100596,1,97317,1,197913,1.59653618804202,3403
480,"AAG","GAG","K","E",2,100596,1,97317,3,197913,1.13326743308567,3404
481,"TCT","ACT","S","T",0,100054,1,97582,1,197636,1.59964790877012,3405
481,"TCT","CCT","S","P",1,100054,0,97582,1,197636,1.56968935165306,3406
481,"TCT","TAT","S","Y",10,100054,5,97582,15,197636,1.43446228321141,3407
481,"TCT","TCC","S","S",1,100054,0,97582,1,197636,1.56968935165306,3408
481,"TCT","TCG","S","S",1,100054,0,97582,1,197636,1.56968935165306,3409
481,"TCT","TCT","S","S",100041,100054,97574,97582,197615,197636,1,3410
481,"TCT","TTT","S","F",0,100054,2,97582,2,197636,2.29770207163568,3411
482,"AGG","AAG","R","K",1,101314,2,97796,3,199110,1.15739219438575,3412
482,"AGG","ACG","R","T",0,101314,1,97796,1,199110,1.59566862694228,3413
482,"AGG","AGA","R","R",5,101314,5,97796,10,199110,0.658361818230242,3414
482,"AGG","AGC","R","S",0,101314,1,97796,1,199110,1.59566862694228,3415
482,"AGG","AGG","R","R",101285,101314,97761,97796,199046,199110,1,3416
482,"AGG","AGT","R","S",7,101314,11,97796,18,199110,1.15739219438575,3417
482,"AGG","ATG","R","M",7,101314,9,97796,16,199110,0.913938121694567,3418
482,"AGG","GGG","R","G",8,101314,6,97796,14,199110,0.932177389598171,3419
482,"AGG","TGG","R","W",1,101314,0,97796,1,199110,1.5531852989036,3420
483,"CTG","ATG","L","M",18,100926,24,98980,42,199906,0.990681384885806,3421
483,"CTG","CAG","L","Q",1,100926,0,98980,1,199906,1.57837392390167,3422
483,"CTG","CCG","L","P",3,100926,0,98980,3,199906,2.79656588351883,3423
483,"CTG","CTA","L","L",8,100926,5,98980,13,199906,1.15182933196263,3424
483,"CTG","CTG","L","L",100865,100926,98918,98980,199783,199906,1,3425
483,"CTG","CTT","L","L",13,100926,9,98980,22,199906,1.05954679655463,3426
483,"CTG","TTG","L","L",18,100926,24,98980,42,199906,0.990681384885806,3427
484,"ATT","AAT","I","N",0,100679,1,99572,1,200251,1.60508160021836,3428
484,"ATT","ACT","I","T",0,100679,1,99572,1,200251,1.60508160021836,3429
484,"ATT","AGT","I","S",2,100679,0,99572,2,200251,2.28283048156158,3430
484,"ATT","ATC","I","I",2,100679,0,99572,2,200251,2.28283048156158,3431
484,"ATT","ATT","I","I",100669,100679,99569,99572,200238,200251,1,3432
484,"ATT","GTT","I","V",6,100679,1,99572,7,200251,2.56369905449362,3433
485,"GAG","AAG","E","K",1,99002,2,100914,3,199916,1.1523714740765,3434
485,"GAG","CAG","E","Q",1,99002,1,100914,2,199916,0.67423420127435,3435
485,"GAG","GAA","E","E",2,99002,3,100914,5,199916,0.997377897578513,3436
485,"GAG","GAG","E","E",98968,99002,100876,100914,199844,199916,1,3437
485,"GAG","GAT","E","D",8,99002,7,100914,15,199916,0.801173663365557,3438
485,"GAG","GCG","E","A",1,99002,0,100914,1,199916,1.60191559013147,3439
485,"GAG","GGG","E","G",12,99002,12,100914,24,199916,0.67423420127435,3440
485,"GAG","GTG","E","V",2,99002,3,100914,5,199916,0.997377897578513,3441
485,"GAG","GTT","E","V",1,99002,0,100914,1,199916,1.60191559013147,3442
485,"GAG","TAG","E",".",6,99002,10,100914,16,199916,1.21694585593274,3443
486,"GCG","ACG","A","T",2,99587,3,100703,5,200290,1.00756257379862,3444
486,"GCG","CCG","A","P",0,99587,1,100703,1,200290,1.59179583613165,3445
486,"GCG","GAG","A","E",10,99587,20,100703,30,200290,1.51840962402497,3446
486,"GCG","GCA","A","A",25,99587,20,100703,45,200290,0.920689288455879,3447
486,"GCG","GCG","A","A",99530,99587,100636,100703,200166,200290,1,3448
486,"GCG","GCT","A","A",4,99587,5,100703,9,200290,0.879013589092561,3449
486,"GCG","GGG","A","G",1,99587,0,100703,1,200290,1.60505648648692,3450
486,"GCG","GTG","A","V",10,99587,10,100703,20,200290,0.682157409880064,3451
486,"GCG","TCG","A","S",5,99587,8,100703,13,200290,1.16340602195065,3452
487,"TCC","CCC","S","P",6,99597,6,101951,12,201548,0.670026472160355,3453
487,"TCC","GCC","S","A",1,99597,0,101951,1,201548,1.60025367700417,3454
487,"TCC","TAC","S","Y",2,99597,2,101951,4,201548,0.670026472160355,3455
487,"TCC","TCA","S","S",4,99597,5,101951,9,201548,0.864650530186214,3456
487,"TCC","TCC","S","S",99576,99597,101933,101951,201509,201548,1,3457
487,"TCC","TCG","S","S",1,99597,0,101951,1,201548,1.60025367700417,3458
487,"TCC","TCT","S","S",6,99597,3,101951,9,201548,1.39048284073077,3459
487,"TCC","TTC","S","F",1,99597,2,101951,3,201548,1.14649739957812,3460
488,"AGT","AAT","S","N",7,98227,5,103693,12,201920,0.983979227368552,3461
488,"AGT","ACT","S","T",0,98227,2,103693,2,201920,2.20560255913674,3462
488,"AGT","AGA","S","R",0,98227,1,103693,1,201920,1.52370751611651,3463
488,"AGT","AGC","S","S",1,98227,1,103693,2,201920,0.6404329108512,3464
488,"AGT","AGT","S","S",98210,98227,103678,103693,201888,201920,1,3465
488,"AGT","ATT","S","I",9,98227,4,103693,13,201920,1.58868445433709,3466
488,"AGT","GGT","S","G",0,98227,1,103693,1,201920,1.52370751611651,3467
488,"AGT","TGT","S","C",0,98227,1,103693,1,201920,1.52370751611651,3468
489,"TTG","CTG","L","L",1,98443,1,104020,2,202463,0.639542426045391,3469
489,"TTG","TTA","L","L",1,98443,3,104020,4,202463,1.52223448578001,3470
489,"TTG","TTG","L","L",98427,98443,104005,104020,202432,202463,1,3471
489,"TTG","TTT","L","F",14,98443,11,104020,25,202463,0.899394103472833,3472
490,"AAT","AAA","N","K",0,97526,1,102651,1,200177,1.52823026621713,3473
490,"AAT","AAC","N","N",1,97526,2,102651,3,200177,1.10877093029388,3474
490,"AAT","AAT","N","N",97510,97526,102642,102651,200152,200177,1,3475
490,"AAT","AGT","N","S",3,97526,1,102651,4,200177,1.58974584545561,3476
490,"AAT","CAT","N","H",1,97526,0,102651,1,200177,1.58974584545561,3477
490,"AAT","GAT","N","D",8,97526,4,102651,12,200177,1.42130014059385,3478
490,"AAT","TAT","N","Y",3,97526,1,102651,4,200177,1.58974584545561,3479
491,"GAT","AAT","D","N",2,96717,3,103231,5,199948,0.940235753034449,3480
491,"GAT","CAT","D","H",0,96717,1,103231,1,199948,1.50658896879115,3481
491,"GAT","GAT","D","D",96700,96717,103210,103231,199910,199948,1,3482
491,"GAT","GGT","D","G",2,96717,3,103231,5,199948,0.940235753034449,3483
491,"GAT","GTT","D","V",1,96717,0,103231,1,199948,1.5847002581252,3484
491,"GAT","TAT","D","Y",12,96717,14,103231,26,199948,0.774131294831604,3485
492,"TCA","CCA","S","P",3,96395,4,101895,7,198290,0.874902500984525,3486
492,"TCA","TAA","S",".",7,96395,7,101895,14,198290,0.639287705360438,3487
492,"TCA","TCA","S","S",96372,96395,101861,101895,198233,198290,1,3488
492,"TCA","TCC","S","S",0,96395,2,101895,2,198290,2.20344679735301,3489
492,"TCA","TCG","S","S",12,96395,8,101895,20,198290,1.09244338679783,3490
492,"TCA","TCT","S","S",0,96395,1,101895,1,198290,1.52181297165629,3491
492,"TCA","TGA","S",".",0,96395,1,101895,1,198290,1.52181297165629,3492
492,"TCA","TTA","S","L",1,96395,11,101895,12,198290,3.50329352274161,3493
493,"GTG","ATG","V","M",4,94748,6,102327,10,197075,0.985892454259727,3494
493,"GTG","GAG","V","E",3,94748,0,102327,3,197075,2.82478061267257,3495
493,"GTG","GTA","V","V",2,94748,3,102327,5,197075,0.925842348560997,3496
493,"GTG","GTG","V","V",94730,94748,102314,102327,197044,197075,1,3497
493,"GTG","GTT","V","V",7,94748,3,102327,10,197075,1.58047167530942,3498
493,"GTG","TTG","V","L",2,94748,1,102327,3,197075,1.13373690443835,3499
494,"GCG","ACG","A","T",1,93101,3,101518,4,194619,1.47332488940968,3500
494,"GCG","CCG","A","P",0,93101,1,101518,1,194619,1.47332488940968,3501
494,"GCG","GAG","A","E",11,93101,8,101518,19,194619,0.962680975189017,3502
494,"GCG","GCA","A","A",7,93101,12,101518,19,194619,1.1695616965593,3503
494,"GCG","GCG","A","A",93030,93101,101448,101518,194478,194619,1,3504
494,"GCG","GCT","A","A",7,93101,5,101518,12,194619,0.962680975189017,3505
494,"GCG","GGG","A","G",0,93101,1,101518,1,194619,1.47332488940968,3506
494,"GCG","GTG","A","V",31,93101,29,101518,60,194619,0.682443985789102,3507
494,"GCG","TCG","A","S",14,93101,11,101518,25,194619,0.876896876842306,3508
495,"ATG","AAG","M","K",0,92526,1,102359,1,194885,1.45127014920609,3509
495,"ATG","ACG","M","T",1,92526,1,102359,2,194885,0.597260087076992,3510
495,"ATG","ATA","M","I",1,92526,1,102359,2,194885,0.597260087076992,3511
495,"ATG","ATG","M","M",92516,92526,102346,102359,194862,194885,1,3512
495,"ATG","ATT","M","I",8,92526,10,102359,18,194885,0.797802534287837,3513
496,"AGA","AAA","R","K",0,91072,2,100511,2,191583,2.12690494025829,3514
496,"AGA","ACA","R","T",1,91072,0,100511,1,191583,1.57297820777359,3515
496,"AGA","AGA","R","R",91053,91072,100491,100511,191544,191583,1,3516
496,"AGA","AGG","R","R",2,91072,2,100511,4,191583,0.599377414540085,3517
496,"AGA","AGT","R","S",1,91072,1,100511,2,191583,0.599377414540085,3518
496,"AGA","ATA","R","I",8,91072,7,100511,15,191583,0.735540609546387,3519
496,"AGA","CGA","R","R",0,91072,1,100511,1,191583,1.4548728936454,3520
496,"AGA","GGA","R","G",7,91072,4,100511,11,191583,1.21816700694064,3521
496,"AGA","TGA","R",".",0,91072,3,100511,3,191583,2.64870744996029,3522
497,"CAG","AAG","Q","K",2,90679,2,99563,4,190242,0.603893132375291,3523
497,"CAG","CAA","Q","Q",8,90679,3,99563,11,190242,1.77354905768395,3524
497,"CAG","CAG","Q","Q",90652,90679,99550,99563,190202,190242,1,3525
497,"CAG","CAT","Q","H",6,90679,4,99563,10,190242,1.02576427296494,3526
497,"CAG","CGG","Q","R",5,90679,2,99563,7,190242,1.57468628433355,3527
497,"CAG","CTG","Q","L",1,90679,0,99563,1,190242,1.57468628433355,3528
497,"CAG","TAG","Q",".",5,90679,2,99563,7,190242,1.57468628433355,3529
498,"ACA","AAA","T","K",1,89485,2,100044,3,189529,1.02967958283187,3530
498,"ACA","ACA","T","T",89479,89485,100036,100044,189515,189529,1,3531
498,"ACA","AGA","T","R",1,89485,0,100044,1,189529,1.56863151676348,3532
498,"ACA","ATA","T","I",1,89485,2,100044,3,189529,1.02967958283187,3533
498,"ACA","CCA","T","P",0,89485,1,100044,1,189529,1.43515583232997,3534
498,"ACA","GCA","T","A",3,89485,3,100044,6,189529,0.587828261293757,3535
499,"TTT","GTT","F","V",2,88642,0,99098,2,187740,2.28239169566336,3536
499,"TTT","TTC","F","F",0,88642,1,99098,1,187740,1.43517141512921,3537
499,"TTT","TTT","F","F",88640,88642,99097,99098,187737,187740,1,3538
500,"GGT","AGT","G","S",1,88812,1,98805,2,187617,0.592254770409822,3539
500,"GGT","CGT","G","R",1,88812,0,98805,1,187617,1.57029379787612,3540
500,"GGT","GAT","G","D",3,88812,6,98805,9,187617,1.2455039826458,3541
500,"GGT","GGA","G","G",0,88812,1,98805,1,187617,1.44273195593569,3542
500,"GGT","GGC","G","G",2,88812,3,98805,5,187617,0.890583986651649,3543
500,"GGT","GGT","G","G",88799,88812,98784,98805,187583,187617,1,3544
500,"GGT","GTT","G","V",0,88812,3,98805,3,187617,2.63397079714264,3545
500,"GGT","TGT","G","C",6,88812,7,98805,13,187617,0.720483159429065,3546
501,"AAT","AAT","N","N",89497,89499,101521,101522,191018,191021,1,3547
501,"AAT","ACT","N","T",1,89499,0,101522,1,191021,1.56384468860495,3548
501,"AAT","ATT","N","I",0,89499,1,101522,1,191021,1.41308491552812,3549
501,"AAT","TAT","N","Y",1,89499,0,101522,1,191021,1.56384468860495,3550
502,"CTG","ATG","L","M",6,88925,6,102276,12,191201,0.562994813071344,3551
502,"CTG","CAG","L","Q",1,88925,1,102276,2,191201,0.562994813071344,3552
502,"CTG","CCG","L","P",2,88925,1,102276,3,191201,1.10058477398416,3553
502,"CTG","CTA","L","L",12,88925,22,102276,34,191201,1.21377681859315,3554
502,"CTG","CTC","L","L",0,88925,1,102276,1,191201,1.39220018320532,3555
502,"CTG","CTG","L","L",88893,88925,102242,102276,191135,191201,1,3556
502,"CTG","CTT","L","L",8,88925,2,102276,10,191201,2.2778746180672,3557
502,"CTG","GTG","L","V",1,88925,0,102276,1,191201,1.5593908508252,3558
502,"CTG","TTG","L","L",2,88925,1,102276,3,191201,1.10058477398416,3559
503,"TAC","AAC","Y","N",0,87251,1,102350,1,189601,1.36274410338619,3560
503,"TAC","CAC","Y","H",5,87251,8,102350,13,189601,0.968932893196507,3561
503,"TAC","TAA","Y",".",4,87251,4,102350,8,189601,0.546226484480485,3562
503,"TAC","TAC","Y","Y",87236,87251,102332,102350,189568,189601,1,3563
503,"TAC","TAG","Y",".",0,87251,2,102350,2,189601,2.02029167152915,3564
503,"TAC","TAT","Y","Y",5,87251,3,102350,8,189601,1.09082366441295,3565
503,"TAC","TGC","Y","C",1,87251,0,102350,1,189601,1.55323254945228,3566
504,"AAA","AAA","K","K",86055,86057,102308,102309,188363,188366,1,3567
504,"AAA","AAT","K","N",1,86057,0,102309,1,188366,1.54915981494881,3568
504,"AAA","AGA","K","R",1,86057,0,102309,1,188366,1.54915981494881,3569
504,"AAA","GAA","K","E",0,86057,1,102309,1,188366,1.34287873338034,3570
505,"ACT","AAT","T","N",2,86815,6,100825,8,187640,1.61675451698374,3571
505,"ACT","ACA","T","T",1,86815,1,100825,2,187640,0.554711122368069,3572
505,"ACT","ACT","T","T",86811,86815,100818,100825,187629,187640,1,3573
505,"ACT","AGT","T","S",1,86815,0,100825,1,187640,1.55634043351835,3574
506,"TTC","CTC","F","L",1,86076,0,102130,1,188206,1.54974047127264,3575
506,"TTC","GTC","F","V",0,86076,1,102130,1,188206,1.34573022854563,3576
506,"TTC","TCC","F","S",2,86076,1,102130,3,188206,1.08527290652314,3577
506,"TTC","TTA","F","L",8,86076,9,102130,17,188206,0.62959423408608,3578
506,"TTC","TTC","F","F",86061,86076,102118,102130,188179,188206,1,3579
506,"TTC","TTG","F","L",1,86076,0,102130,1,188206,1.54974047127264,3580
506,"TTC","TTT","F","F",3,86076,1,102130,4,188206,1.54974047127264,3581
507,"CAC","AAC","H","N",3,85443,3,102477,6,187920,0.527740504484567,3582
507,"CAC","CAA","H","Q",3,85443,3,102477,6,187920,0.527740504484567,3583
507,"CAC","CAC","H","H",85430,85443,102468,102477,187898,187920,1,3584
507,"CAC","CAG","H","Q",1,85443,1,102477,2,187920,0.527740504484567,3585
507,"CAC","CAT","H","H",2,85443,0,102477,2,187920,2.27162038789254,3586
507,"CAC","CCC","H","P",0,85443,1,102477,1,187920,1.32982761507724,3587
507,"CAC","CGC","H","R",1,85443,1,102477,2,187920,0.527740504484567,3588
507,"CAC","TAC","H","Y",3,85443,0,102477,3,187920,2.81511513814142,3589
508,"CTA","ATA","L","I",8,86323,9,101924,17,188247,0.634241179898217,3590
508,"CTA","CCA","L","P",7,86323,11,101924,18,188247,0.96087747827893,3591
508,"CTA","CGA","L","R",1,86323,0,101924,1,188247,1.55124264935575,3592
508,"CTA","CTA","L","L",86306,86323,101902,101924,188208,188247,1,3593
508,"CTA","CTC","L","L",0,86323,1,101924,1,188247,1.3530772584224,3594
508,"CTA","CTT","L","L",1,86323,0,101924,1,188247,1.55124264935575,3595
508,"CTA","TTA","L","L",0,86323,1,101924,1,188247,1.3530772584224,3596
509,"AAC","AAA","N","K",3,86229,2,99475,5,185704,0.927905910347168,3597
509,"AAC","AAC","N","N",86222,86229,99466,99475,185688,185704,1,3598
509,"AAC","AAG","N","K",0,86229,1,99475,1,185704,1.38772280410779,3599
509,"AAC","AAT","N","N",2,86229,3,99475,5,185704,0.848386382930404,3600
509,"AAC","ACC","N","T",1,86229,0,99475,1,185704,1.55844551249928,3601
509,"AAC","AGC","N","S",0,86229,1,99475,1,185704,1.38772280410779,3602
509,"AAC","CAC","N","H",0,86229,2,99475,2,185704,2.04935148941066,3603
509,"AAC","TAC","N","Y",1,86229,0,99475,1,185704,1.55844551249928,3604
510,"CCA","ACA","P","T",8,85564,6,99388,14,184952,0.873111067015415,3605
510,"CCA","CAA","P","Q",4,85564,8,99388,12,184952,1.22429587940094,3606
510,"CCA","CCA","P","P",85546,85564,99359,99388,184905,184952,1,3607
510,"CCA","CCC","P","P",0,85564,4,99388,4,184952,2.97206314650461,3608
510,"CCA","CCG","P","P",2,85564,6,99388,8,184952,1.61659147696361,3609
510,"CCA","CCT","P","P",0,85564,2,99388,2,184952,2.0375230199056,3610
510,"CCA","CTA","P","L",3,85564,3,99388,6,184952,0.554624513245439,3611
510,"CCA","TCA","P","S",1,85564,0,99388,1,184952,1.55630862454467,3612
511,"GGG","AGG","G","R",1,85978,4,100895,5,186873,1.71194283932613,3613
511,"GGG","GAG","G","E",1,85978,2,100895,3,186873,0.96861634149866,3614
511,"GGG","GGA","G","G",0,85978,2,100895,2,186873,2.01984915176269,3615
511,"GGG","GGC","G","G",0,85978,1,100895,1,186873,1.36236452124522,3616
511,"GGG","GGG","G","G",85972,85978,100875,100895,186847,186873,1,3617
511,"GGG","GGT","G","G",1,85978,4,100895,5,186873,1.71194283932613,3618
511,"GGG","GTG","G","V",3,85978,5,100895,8,186873,0.96861634149866,3619
511,"GGG","TGG","G","W",0,85978,2,100895,2,186873,2.01984915176269,3620
512,"GTT","ATT","V","I",2,87198,4,101244,6,188442,1.1187506466591,3621
512,"GTT","GCT","V","A",0,87198,1,101244,1,188442,1.37823184926865,3622
512,"GTT","GTA","V","V",1,87198,0,101244,1,188442,1.55645264072806,3623
512,"GTT","GTC","V","V",1,87198,9,101244,10,188442,2.97293679850893,3624
512,"GTT","GTG","V","V",0,87198,2,101244,2,188442,2.03832381687508,3625
512,"GTT","GTT","V","V",87191,87198,101223,101244,188414,188442,1,3626
512,"GTT","TTT","V","F",3,87198,5,101244,8,188442,0.981865821265538,3627
513,"GTG","ATG","V","M",6,89306,2,101505,8,190811,1.82753380361097,3628
513,"GTG","GAG","V","E",0,89306,1,101505,1,190811,1.41009600850534,3629
513,"GTG","GCG","V","A",0,89306,1,101505,1,190811,1.41009600850534,3630
513,"GTG","GTA","V","V",1,89306,1,101505,2,190811,0.573286018743606,3631
513,"GTG","GTC","V","V",0,89306,3,101505,3,190811,2.59416416312872,3632
513,"GTG","GTG","V","V",89286,89306,101482,101505,190768,190811,1,3633
513,"GTG","GTT","V","V",9,89306,11,101505,20,190811,0.748906111618701,3634
513,"GTG","TTG","V","L",4,89306,4,101505,8,190811,0.573286018743606,3635
514,"ACT","AAT","T","N",2,90610,1,101532,3,192142,1.11395254265529,3636
514,"ACT","ACC","T","T",1,90610,5,101532,6,192142,2.10014817575159,3637
514,"ACT","ACT","T","T",90598,90610,101522,101532,192120,192142,1,3638
514,"ACT","ATT","T","I",5,90610,3,101532,8,192142,1.11395254265529,3639
514,"ACT","GCT","T","A",4,90610,1,101532,5,192142,1.95251337951391,3640
515,"GGT","AGT","G","S",4,90682,9,101509,13,192191,1.43329403980368,3641
515,"GGT","CGT","G","R",0,90682,1,101509,1,192191,1.43329403980368,3642
515,"GGT","GAT","G","D",2,90682,3,101509,5,192191,0.883305852193783,3643
515,"GGT","GCT","G","A",1,90682,0,101509,1,192191,1.56822452305827,3644
515,"GGT","GGA","G","G",1,90682,0,101509,1,192191,1.56822452305827,3645
515,"GGT","GGC","G","G",1,90682,4,101509,5,192191,1.78980096124975,3646
515,"GGT","GGT","G","G",90666,90682,101487,101509,192153,192191,1,3647
515,"GGT","GTT","G","V",3,90682,3,101509,6,192191,0.586742604672603,3648
515,"GGT","TGT","G","C",4,90682,2,101509,6,192191,1.27421673892906,3649
516,"AGT","AAT","S","N",3,88407,2,100821,5,189228,0.934779645974777,3650
516,"AGT","ACT","S","T",0,88407,1,100821,1,189228,1.40499290174378,3651
516,"AGT","AGC","S","S",1,88407,0,100821,1,189228,1.5621103133372,3652
516,"AGT","AGG","S","R",0,88407,1,100821,1,189228,1.40499290174378,3653
516,"AGT","AGT","S","S",88400,88407,100815,100821,189215,189228,1,3654
516,"AGT","ATT","S","I",2,88407,0,100821,2,189228,2.279201255023,3655
516,"AGT","GGT","S","G",1,88407,2,100821,3,189228,1.00428971146433,3656
517,"GCT","ACT","A","T",16,88134,21,99345,37,187479,0.840717285943677,3657
517,"GCT","GAT","A","D",9,88134,7,99345,16,187479,0.854204651236176,3658
517,"GCT","GCA","A","A",1,88134,0,99345,1,187479,1.56590494683906,3659
517,"GCT","GCC","A","A",5,88134,4,99345,9,187479,0.800657616106916,3660
517,"GCT","GCT","A","A",88078,88134,99284,99345,187362,187479,1,3661
517,"GCT","GGT","A","G",0,88134,1,99345,1,187479,1.42263107472102,3662
517,"GCT","GTT","A","V",12,88134,15,99345,27,187479,0.784882581771845,3663
517,"GCT","TCT","A","S",13,88134,13,99345,26,187479,0.580541012550992,3664
518,"GTT","ATT","V","I",15,86894,12,100215,27,187109,0.818213527399933,3665
518,"GTT","GCT","V","A",3,86894,0,100215,3,187109,2.81849702195209,3666
518,"GTT","GTT","V","V",86873,86894,100202,100215,187075,187109,1,3667
518,"GTT","TTT","V","F",3,86894,1,100215,4,187109,1.55849284653464,3668
519,"GGG","AGG","G","R",4,85986,2,99227,6,185213,1.26091341331726,3669
519,"GGG","GAG","G","E",2,85986,2,99227,4,185213,0.560110150085569,3670
519,"GGG","GGA","G","G",4,85986,3,99227,7,185213,0.838703324793473,3671
519,"GGG","GGC","G","G",1,85986,0,99227,1,185213,1.55832677990516,3672
519,"GGG","GGG","G","G",85960,85986,99201,99227,185161,185213,1,3673
519,"GGG","GGT","G","G",4,85986,4,99227,8,185213,0.560110150085569,3674
519,"GGG","GTG","G","V",8,85986,8,99227,16,185213,0.560110150085569,3675
519,"GGG","TGG","G","W",3,85986,7,99227,10,185213,1.38715933456517,3676
520,"TGT","AGT","C","S",1,85121,0,100849,1,185970,1.55019722251248,3677
520,"TGT","CGT","C","R",1,85121,2,100849,3,185970,0.956625760478684,3678
520,"TGT","GGT","C","G",0,85121,1,100849,1,185970,1.34796870878274,3679
520,"TGT","TAT","C","Y",3,85121,5,100849,8,185970,0.956625760478684,3680
520,"TGT","TCT","C","S",1,85121,0,100849,1,185970,1.55019722251248,3681
520,"TGT","TGC","C","C",3,85121,3,100849,6,185970,0.537895592914187,3682
520,"TGT","TGG","C","W",0,85121,1,100849,1,185970,1.34796870878274,3683
520,"TGT","TGT","C","C",85105,85121,100831,100849,185936,185970,1,3684
520,"TGT","TTT","C","F",7,85121,6,100849,13,185970,0.702365526346524,3685
521,"GAC","AAC","D","N",3,83932,4,100203,7,184135,0.740175129403496,3686
521,"GAC","CAC","D","H",1,83932,1,100203,2,184135,0.531588770913752,3687
521,"GAC","GAA","D","E",0,83932,1,100203,1,184135,1.33671924057062,3688
521,"GAC","GAC","D","D",83910,83932,100175,100203,184085,184135,1,3689
521,"GAC","GAT","D","D",3,83932,3,100203,6,184135,0.531588770913752,3690
521,"GAC","GGC","D","G",5,83932,6,100203,11,184135,0.670390900202716,3691
521,"GAC","GTC","D","V",0,83932,1,100203,1,184135,1.33671924057062,3692
521,"GAC","TAC","D","Y",10,83932,12,100203,22,184135,0.683080524041751,3693
522,"CCA","ACA","P","T",6,83363,7,97771,13,181134,0.667572329489562,3694
522,"CCA","CAA","P","Q",7,83363,5,97771,12,181134,0.918184066304685,3695
522,"CCA","CCA","P","P",83340,83363,97746,97771,181086,181134,1,3696
522,"CCA","CCG","P","P",1,83363,5,97771,6,181134,2.02057230350496,3697
522,"CCA","CCT","P","P",0,83363,1,97771,1,181134,1.3629848346972,3698
522,"CCA","CTA","P","L",6,83363,3,97771,9,181134,1.33222353982114,3699
522,"CCA","TCA","P","S",3,83363,4,97771,7,181134,0.758876429527443,3700
523,"GAC","AAC","D","N",2,82826,2,96337,4,179163,0.553270471389303,3701
523,"GAC","CAC","D","H",0,82826,1,96337,1,179163,1.37516349403469,3702
523,"GAC","GAA","D","E",6,82826,3,96337,9,179163,1.33537753580861,3703
523,"GAC","GAC","D","D",82795,82826,96317,96337,179112,179163,1,3704
523,"GAC","GAT","D","D",3,82826,3,96337,6,179163,0.553270471389303,3705
523,"GAC","GGC","D","G",3,82826,1,96337,4,179163,1.55581155157464,3706
523,"GAC","TAC","D","Y",17,82826,10,96337,27,179163,1.22865082233816,3707
524,"CTC","ATC","L","I",10,81065,4,95639,14,176704,1.71528335068889,3708
524,"CTC","CAC","L","H",1,81065,3,95639,4,176704,1.35402963113724,3709
524,"CTC","CCC","L","P",4,81065,2,95639,6,176704,1.25162746721794,3710
524,"CTC","CTA","L","L",6,81065,4,95639,10,176704,0.9851636795295,3711
524,"CTC","CTC","L","L",81040,81065,95623,95639,176663,176704,1,3712
524,"CTC","CTG","L","L",2,81065,0,95639,2,176704,2.27400558408636,3713
524,"CTC","CTT","L","L",0,81065,1,95639,1,176704,1.35402963113724,3714
524,"CTC","TTC","L","F",2,81065,2,95639,4,176704,0.541306460967453,3715
525,"TTT","CTT","F","L",6,80736,3,95504,9,176240,1.32893928693382,3716
525,"TTT","TCT","F","S",1,80736,0,95504,1,176240,1.55065027108039,3717
525,"TTT","TTA","F","L",2,80736,0,95504,2,176240,2.27362320847099,3718
525,"TTT","TTT","F","F",80727,80736,95501,95504,176228,176240,1,3719
526,"TGG","AGG","W","R",0,82011,1,95119,1,177130,1.37976172377141,3720
526,"TGG","TAG","W",".",0,82011,3,95119,3,177130,2.55690310866631,3721
526,"TGG","TCG","W","S",2,82011,1,95119,3,177130,1.09643948114355,3722
526,"TGG","TGA","W",".",2,82011,1,95119,3,177130,1.09643948114355,3723
526,"TGG","TGG","W","W",81998,82011,95097,95119,177095,177130,1,3724
526,"TGG","TGT","W","C",7,82011,10,95119,17,177130,0.877823561059468,3725
526,"TGG","TTG","W","L",2,82011,6,95119,8,177130,1.61896888238662,3726
527,"AGC","AAC","S","N",4,82700,5,94320,9,177020,0.745177101104073,3727
527,"AGC","ACC","S","T",0,82700,1,94320,1,177020,1.40474430456203,3728
527,"AGC","AGA","S","R",8,82700,7,94320,15,177020,0.710125330234072,3729
527,"AGC","AGC","S","S",82650,82700,94273,94320,176923,177020,1,3730
527,"AGC","AGG","S","R",2,82700,1,94320,3,177020,1.10480016925919,3731
527,"AGC","AGT","S","S",21,82700,12,94320,33,177020,1.28992841737615,3732
527,"AGC","ATC","S","I",8,82700,10,94320,18,177020,0.764624331859079,3733
527,"AGC","GGC","S","G",7,82700,10,94320,17,177020,0.897382878613094,3734
527,"AGC","TGC","S","C",0,82700,1,94320,1,177020,1.40474430456203,3735
528,"AAG","AAA","K","K",2,82858,2,93844,4,176702,0.576350804835,3736
528,"AAG","AAC","K","N",0,82858,1,93844,1,176702,1.41539937642948,3737
528,"AAG","AAG","K","K",82847,82858,93834,93844,176681,176702,1,3738
528,"AAG","AAT","K","N",7,82858,5,93844,12,176702,0.938956113760473,3739
528,"AAG","ACG","K","T",1,82858,0,93844,1,176702,1.56434278136764,3740
528,"AAG","CAG","K","Q",0,82858,1,93844,1,176702,1.41539937642948,3741
528,"AAG","CCG","K","P",1,82858,0,93844,1,176702,1.56434278136764,3742
528,"AAG","GAG","K","E",0,82858,1,93844,1,176702,1.41539937642948,3743
529,"ATA","AAA","I","K",0,81569,1,93620,1,175189,1.39537272622571,3744
529,"ATA","ATA","I","I",81566,81569,93617,93620,175183,175189,1,3745
529,"ATA","ATG","I","M",0,81569,2,93620,2,175189,2.05822777316039,3746
529,"ATA","ATT","I","I",1,81569,0,93620,1,175189,1.56006271383934,3747
529,"ATA","CTA","I","L",2,81569,0,93620,2,175189,2.27820220152599,3748
530,"CCA","ACA","P","T",0,81596,3,91823,3,173419,2.61258102553466,3749
530,"CCA","CAA","P","Q",4,81596,8,91823,12,173419,1.26931792617724,3750
530,"CCA","CCA","P","P",81573,81596,91798,91823,173371,173419,1,3751
530,"CCA","CCC","P","P",1,81596,0,91823,1,173419,1.56645467375146,3752
530,"CCA","CCG","P","P",3,81596,2,91823,5,173419,0.942899559281332,3753
530,"CCA","CGA","P","R",0,81596,1,91823,1,173419,1.42516619639543,3754
530,"CCA","CTA","P","L",5,81596,5,91823,10,173419,0.582012934672062,3755
530,"CCA","GCA","P","A",3,81596,0,91823,3,173419,2.82076186456014,3756
530,"CCA","TCA","P","S",7,81596,6,91823,13,173419,0.739916103049119,3757
531,"GTG","ATG","V","M",2,80805,4,91787,6,172592,1.14823320597609,3758
531,"GTG","CTG","V","L",0,80805,1,91787,1,172592,1.41093084089873,3759
531,"GTG","GAG","V","E",1,80805,0,91787,1,172592,1.56338192474659,3760
531,"GTG","GAT","V","D",0,80805,1,91787,1,172592,1.41093084089873,3761
531,"GTG","GCG","V","A",1,80805,0,91787,1,172592,1.56338192474659,3762
531,"GTG","GTA","V","V",1,80805,2,91787,3,172592,1.00927841580318,3763
531,"GTG","GTG","V","V",80784,80805,91768,91787,172552,172592,1,3764
531,"GTG","GTT","V","V",11,80805,7,91787,18,172592,1.10689207162688,3765
531,"GTG","TTG","V","L",5,80805,4,91787,9,172592,0.795226428208496,3766
532,"ATG","ATA","M","I",1,83467,0,91295,1,174762,1.57606939555828,3767
532,"ATG","ATC","M","I",1,83467,0,91295,1,174762,1.57606939555828,3768
532,"ATG","ATG","M","M",83461,83467,91286,91295,174747,174762,1,3769
532,"ATG","ATT","M","I",4,83467,7,91295,11,174762,1.14420066868678,3770
532,"ATG","GTG","M","V",0,83467,2,91295,2,174762,2.14279105872839,3771
533,"TTA","CTA","L","L",0,83300,1,91596,1,174896,1.4604908691933,3772
533,"TTA","TCA","L","S",2,83300,0,91596,2,174896,2.28513557457127,3773
533,"TTA","TTA","L","L",83296,83300,91594,91596,174890,174896,1,3774
533,"TTA","TTG","L","L",0,83300,1,91596,1,174896,1.4604908691933,3775
533,"TTA","TTT","L","F",2,83300,0,91596,2,174896,2.28513557457127,3776
534,"GAT","AAT","D","N",0,83553,1,90636,1,174189,1.48144997561794,3777
534,"GAT","GAC","D","D",1,83553,2,90636,3,174189,1.06888047307487,3778
534,"GAT","GAT","D","D",83540,83553,90621,90636,174161,174189,1,3779
534,"GAT","GGT","D","G",3,83553,0,90636,3,174189,2.82434056721051,3780
534,"GAT","TAT","D","Y",9,83553,12,90636,21,174189,0.890444655273138,3781
535,"GGA","AGA","G","R",3,82950,2,89682,5,172632,0.968245890511694,3782
535,"GGA","CGA","G","R",0,82950,2,89682,2,172632,2.1633105482609,3783
535,"GGA","GAA","G","E",5,82950,6,89682,11,172632,0.772184655118493,3784
535,"GGA","GGA","G","G",82925,82950,89653,89682,172578,172632,1,3785
535,"GGA","GGG","G","G",2,82950,5,89682,7,172632,1.48663142507561,3786
535,"GGA","GTA","G","V",7,82950,5,89682,12,172632,0.968245890511694,3787
535,"GGA","TGA","G",".",8,82950,9,89682,17,172632,0.720872524393297,3788
536,"CAT","AAT","H","N",1,82627,2,91171,3,173798,1.04667478724951,3789
536,"CAT","CAC","H","H",1,82627,0,91171,1,173798,1.57306568828229,3790
536,"CAT","CAG","H","Q",0,82627,1,91171,1,173798,1.45526662252742,3791
536,"CAT","CAT","H","H",82625,82627,91166,91171,173791,173798,1,3792
536,"CAT","TAT","H","Y",0,82627,2,91171,2,173798,2.12735732426689,3793
537,"CTC","ATC","L","I",8,82637,7,90083,15,172720,0.745287210929965,3794
537,"CTC","CAC","L","H",1,82637,0,90083,1,172720,1.57720837902672,3795
537,"CTC","CCC","L","P",2,82637,2,90083,4,172720,0.610537835779025,3796
537,"CTC","CGC","L","R",1,82637,0,90083,1,172720,1.57720837902672,3797
537,"CTC","CTA","L","L",10,82637,10,90083,20,172720,0.610537835779025,3798
537,"CTC","CTC","L","L",82612,82637,90061,90083,172673,172720,1,3799
537,"CTC","CTG","L","L",1,82637,0,90083,1,172720,1.57720837902672,3800
537,"CTC","CTT","L","L",1,82637,1,90083,2,172720,0.610537835779025,3801
537,"CTC","TTC","L","F",1,82637,2,90083,3,172720,1.06236260589738,3802
538,"ATA","ACA","I","T",1,82510,1,90167,2,172677,0.608342120710206,3803
538,"ATA","ATA","I","I",82505,82510,90161,90167,172666,172677,1,3804
538,"ATA","ATG","I","M",3,82510,5,90167,8,172677,1.05921674347267,3805
538,"ATA","TTA","I","L",1,82510,0,90167,1,172677,1.57637381280217,3806
539,"GCA","ACA","A","T",13,82246,8,90255,21,172501,1.17866838183537,3807
539,"GCA","GAA","A","E",9,82246,12,90255,21,172501,0.876797356126849,3808
539,"GCA","GCA","A","A",82215,82246,90227,90255,172442,172501,1,3809
539,"GCA","GCT","A","A",1,82246,0,90255,1,172501,1.57490659354343,3810
539,"GCA","GTA","A","V",2,82246,1,90255,3,172501,1.12502388368516,3811
539,"GCA","TCA","A","S",6,82246,7,90255,13,172501,0.734510285833418,3812
540,"TTT","CTT","F","L",1,81752,0,89616,1,171368,1.57528802832838,3813
540,"TTT","GTT","F","V",1,81752,0,89616,1,171368,1.57528802832838,3814
540,"TTT","TAT","F","Y",1,81752,0,89616,1,171368,1.57528802832838,3815
540,"TTT","TTC","F","F",2,81752,2,89616,4,171368,0.605480975913424,3816
540,"TTT","TTT","F","F",81747,81752,89614,89616,171361,171368,1,3817
541,"GAT","CAT","D","H",0,82413,1,88518,1,170931,1.49691951249983,3819
541,"GAT","GAC","D","D",1,82413,1,88518,2,170931,0.624320080015712,3820
541,"GAT","GAT","D","D",82399,82413,88495,88518,170894,170931,1,3821
541,"GAT","GGT","D","G",4,82413,5,88518,9,170931,0.810239146028633,3822
541,"GAT","GTT","D","V",1,82413,0,88518,1,170931,1.58247282667023,3823
541,"GAT","TAT","D","Y",8,82413,9,88518,17,170931,0.727713281144978,3824
542,"TAC","CAC","Y","H",1,83095,0,87022,1,170117,1.59161840749055,3825
542,"TAC","TAA","Y",".",4,83095,2,87022,6,170117,1.30548265248859,3826
542,"TAC","TAC","Y","Y",83086,83095,87017,87022,170103,170117,1,3827
542,"TAC","TAT","Y","Y",2,83095,3,87022,5,170117,0.963473928759264,3828
542,"TAC","TGC","Y","C",2,83095,0,87022,2,170117,2.29371503184169,3829
543,"TCT","CCT","S","P",2,83538,3,87455,5,170993,0.963979207290575,3830
543,"TCT","TAT","S","Y",11,83538,9,87455,20,170993,0.855451677529426,3831
543,"TCT","TCC","S","S",0,83538,1,87455,1,170993,1.53681275225529,3832
543,"TCT","TCT","S","S",83524,83538,87440,87455,170964,170993,1,3833
543,"TCT","TGT","S","C",1,83538,1,87455,2,170993,0.648378179470898,3834
543,"TCT","TTT","S","F",0,83538,1,87455,1,170993,1.53681275225529,3835
544,"GGG","AGG","G","R",1,82449,1,86262,2,168711,0.648916061701054,3836
544,"GGG","CGG","G","R",0,82449,1,86262,1,168711,1.53769752069242,3837
544,"GGG","GAG","G","E",0,82449,1,86262,1,168711,1.53769752069242,3838
544,"GGG","GGA","G","G",4,82449,3,86262,7,168711,0.906630471787941,3839
544,"GGG","GGG","G","G",82428,82449,86244,86262,168672,168711,1,3840
544,"GGG","GGT","G","G",5,82449,5,86262,10,168711,0.648916061701054,3841
544,"GGG","GTG","G","V",3,82449,3,86262,6,168711,0.648916061701054,3842
544,"GGG","TGG","G","W",8,82449,4,86262,12,168711,1.42394307631364,3843
545,"TAC","AAC","Y","N",0,82087,2,86350,2,168437,2.21172624939427,3844
545,"TAC","CAC","Y","H",1,82087,0,86350,1,168437,1.58994846503751,3845
545,"TAC","TAA","Y",".",2,82087,3,86350,5,168437,0.957899170139066,3846
545,"TAC","TAC","Y","Y",82053,82087,86324,86350,168377,168437,1,3847
545,"TAC","TAT","Y","Y",27,82087,19,86350,46,168437,1.05204333290022,3848
545,"TAC","TCC","Y","S",1,82087,0,86350,1,168437,1.58994846503751,3849
545,"TAC","TGC","Y","C",1,82087,2,86350,3,168437,1.10950821050151,3850
545,"TAC","TTC","Y","F",2,82087,0,86350,2,168437,2.2928878483643,3851
546,"GAT","AAT","D","N",12,82933,7,84896,19,167829,1.27946119845422,3852
546,"GAT","GAT","D","D",82913,82933,84885,84896,167798,167829,1,3853
546,"GAT","GCT","D","A",0,82933,1,84896,1,167829,1.57200796881285,3854
546,"GAT","GGT","D","G",0,82933,1,84896,1,167829,1.57200796881285,3855
546,"GAT","TAT","D","Y",8,82933,2,84896,10,167829,2.29798225341166,3856
547,"GCT","ACT","A","T",12,82125,14,85503,26,167628,0.801255059654247,3857
547,"GCT","GAT","A","D",9,82125,7,85503,16,167628,0.91031962791375,3858
547,"GCT","GCA","A","A",0,82125,1,85503,1,167628,1.54553212473478,3859
547,"GCT","GCC","A","A",1,82125,0,85503,1,167628,1.59384024260167,3860
547,"GCT","GCT","A","A",82082,82125,85455,85503,167537,167628,1,3861
547,"GCT","GTT","A","V",15,82125,16,85503,31,167628,0.713708236146569,3862
547,"GCT","TCT","A","S",6,82125,10,85503,16,167628,1.18732451610094,3863
548,"AGC","AAC","S","N",2,82286,6,84518,8,166804,1.81825487306362,3864
548,"AGC","AGA","S","R",8,82286,5,84518,13,166804,1.16251205032444,3865
548,"AGC","AGC","S","S",82263,82286,84491,84518,166754,166804,1,3866
548,"AGC","AGT","S","S",0,82286,1,84518,1,166804,1.56691165176273,3867
548,"AGC","ATC","S","I",12,82286,14,84518,26,166804,0.816281395835729,3868
548,"AGC","CGC","S","R",1,82286,0,84518,1,166804,1.59897468778667,3869
548,"AGC","GGC","S","G",0,82286,1,84518,1,166804,1.56691165176273,3870
549,"TTA","CTA","L","L",4,81943,3,83980,7,165923,0.922066653228911,3871
549,"TTA","GTA","L","V",1,81943,0,83980,1,165923,1.59978781675173,3872
549,"TTA","TAA","L",".",0,81943,1,83980,1,165923,1.5702658771286,3873
549,"TTA","TCA","L","S",2,81943,1,83980,3,165923,1.16376986358225,3874
549,"TTA","TTA","L","L",81934,81943,83975,83980,165909,165923,1,3875
549,"TTA","TTG","L","L",1,81943,0,83980,1,165923,1.59978781675173,3876
549,"TTA","TTT","L","F",1,81943,0,83980,1,165923,1.59978781675173,3877
550,"AGC","AAC","S","N",2,82028,9,82549,11,164577,2.48250438264935,3878
550,"AGC","AGA","S","R",7,82028,7,82549,14,164577,0.686831611912081,3879
550,"AGC","AGC","S","S",81972,82028,82493,82549,164465,164577,1,3880
550,"AGC","AGT","S","S",22,82028,14,82549,36,164577,1.20552752803246,3881
550,"AGC","ATC","S","I",25,82028,25,82549,50,164577,0.686831611912081,3882
550,"AGC","GGC","S","G",0,82028,1,82549,1,164577,1.5993137680189,3883
551,"CCT","ACT","P","T",6,81202,5,78446,11,159648,0.819908263537682,3884
551,"CCT","CAT","P","H",8,81202,8,78446,16,159648,0.659215679181785,3885
551,"CCT","CCC","P","P",7,81202,5,78446,12,159648,0.978008900515543,3886
551,"CCT","CCG","P","P",1,81202,1,78446,2,159648,0.659215679181785,3887
551,"CCT","CCT","P","P",81176,81202,78421,78446,159597,159648,1,3888
551,"CCT","CGT","P","R",0,81202,1,78446,1,159648,1.59600315516327,3889
551,"CCT","CTT","P","L",0,81202,3,78446,3,159648,2.82928064650747,3890
551,"CCT","TCT","P","S",4,81202,2,78446,6,159648,1.27882934199348,3891
552,"GTC","ATC","V","I",3,82070,4,77800,7,159870,0.900545588322927,3892
552,"GTC","GAC","V","D",0,82070,1,77800,1,159870,1.58891789111065,3893
552,"GTC","GCC","V","A",4,82070,3,77800,7,159870,0.877059533885983,3894
552,"GTC","GTA","V","V",6,82070,8,77800,14,159870,0.936684020977919,3895
552,"GTC","GTC","V","V",82053,82070,77775,77800,159828,159870,1,3896
552,"GTC","GTG","V","V",0,82070,1,77800,1,159870,1.58891789111065,3897
552,"GTC","GTT","V","V",1,82070,1,77800,2,159870,0.641035344959388,3898
552,"GTC","TTC","V","F",3,82070,7,77800,10,159870,1.58891789111065,3899
553,"TGG","AGG","W","R",0,82333,1,78101,1,160434,1.58916673295499,3900
553,"TGG","CGG","W","R",0,82333,3,78101,3,160434,2.82729376953638,3901
553,"TGG","GGG","W","G",0,82333,1,78101,1,160434,1.58916673295499,3902
553,"TGG","TAG","W",".",3,82333,2,78101,5,160434,0.95528201556152,3903
553,"TGG","TGA","W",".",2,82333,3,78101,5,160434,0.984861964068107,3904
553,"TGG","TGC","W","C",1,82333,0,78101,1,160434,1.52576451996916,3905
553,"TGG","TGG","W","W",82320,82333,78081,78101,160401,160434,1,3906
553,"TGG","TGT","W","C",2,82333,2,78101,4,160434,0.641677290524829,3907
553,"TGG","TTG","W","L",5,82333,8,78101,13,160434,1.14729593856021,3908
554,"TTT","CTT","F","L",1,83095,2,77195,3,160290,1.13559002755523,3909
554,"TTT","GTT","F","V",1,83095,1,77195,2,160290,0.622193331907072,3910
554,"TTT","TCT","F","S",0,83095,1,77195,1,160290,1.58165753896259,3911
554,"TTT","TTC","F","F",1,83095,0,77195,1,160290,1.49336220487655,3912
554,"TTT","TTT","F","F",83092,83095,77191,77195,160283,160290,1,3913
555,"GCT","ACT","A","T",11,83768,10,79412,21,163180,0.727576566675085,3914
555,"GCT","CCT","A","P",1,83768,0,79412,1,163180,1.52531329255656,3915
555,"GCT","GAT","A","D",12,83768,7,79412,19,163180,1.21618997665766,3916
555,"GCT","GCA","A","A",3,83768,0,79412,3,163180,2.73347969182059,3917
555,"GCT","GCC","A","A",0,83768,1,79412,1,163180,1.5890608745708,3918
555,"GCT","GCT","A","A",83701,83768,79368,79412,163069,163180,1,3919
555,"GCT","GTT","A","V",25,83768,22,79412,47,163180,0.765004023185007,3920
555,"GCT","TCT","A","S",15,83768,4,79412,19,163180,2.32309860019675,3921
556,"TGC","CGC","C","R",1,83368,2,80156,3,163524,1.15512310953854,3922
556,"TGC","TAC","C","Y",12,83368,11,80156,23,163524,0.734722220835314,3923
556,"TGC","TGA","C",".",7,83368,6,80156,13,163524,0.791814505713626,3924
556,"TGC","TGC","C","C",83325,83368,80114,80156,163439,163524,1,3925
556,"TGC","TGT","C","C",12,83368,11,80156,23,163524,0.734722220835314,3926
556,"TGC","TTC","C","F",11,83368,12,80156,23,163524,0.74099657150795,3927
557,"CTA","AAA","L","K",0,83914,1,80254,1,164168,1.59221515421924,3928
557,"CTA","ATA","L","I",7,83914,7,80254,14,164168,0.649521012427106,3929
557,"CTA","CAA","L","Q",5,83914,8,80254,13,164168,1.15203410016948,3930
557,"CTA","CCA","L","P",7,83914,8,80254,15,164168,0.779438874186878,3931
557,"CTA","CTA","L","L",83889,83914,80228,80254,164117,164168,1,3932
557,"CTA","GTA","L","V",1,83914,0,80254,1,164168,1.53869224438216,3933
557,"CTA","TTA","L","L",5,83914,2,80254,7,164168,1.53869224438216,3934
558,"AAA","AAA","K","K",83152,83153,79764,79766,162916,162919,1,3935
558,"AAA","AAG","K","K",0,83153,2,79766,2,162919,2.29457023431737,3936
558,"AAA","TAA","K",".",1,83153,0,79766,1,162919,1.54344489116599,3937
559,"ATG","ATA","M","I",1,82853,5,79732,6,162585,2.29516517965862,3938
559,"ATG","ATG","M","M",82846,82853,79725,79732,162571,162585,1,3939
559,"ATG","ATT","M","I",4,82853,2,79732,6,162585,1.27324655174712,3940
559,"ATG","TTG","M","L",2,82853,0,79732,2,162585,2.23373640722514,3941
560,"TTA","CTA","L","L",1,82518,0,79580,1,162098,1.55179863825544,3942
560,"TTA","TCA","L","S",0,82518,1,79580,1,162098,1.59533655593751,3943
560,"TTA","TTA","L","L",82516,82518,79575,79580,162091,162098,1,3944
560,"TTA","TTG","L","L",1,82518,2,79580,3,162098,1.15687742624326,3945
560,"TTA","TTT","L","F",0,82518,2,79580,2,162098,2.29555927057169,3946
561,"CTT","ATT","L","I",1,82825,2,78106,3,160931,1.14400347559459,3947
561,"CTT","CCT","L","P",0,82825,1,78106,1,160931,1.58705147498894,3948
561,"CTT","CTC","L","L",5,82825,1,78106,6,160931,2.19764699635,3949
561,"CTT","CTT","L","L",82819,82825,78101,78106,160920,160931,1,3950
561,"CTT","GTT","L","V",0,82825,1,78106,1,160931,1.58705147498894,3951
562,"GAG","AAG","E","K",1,83298,1,78149,2,161447,0.631303923520671,3952
562,"GAG","GAA","E","E",3,83298,1,78149,4,161447,1.50856547624365,3953
562,"GAG","GAG","E","E",83283,83298,78129,78149,161412,161447,1,3954
562,"GAG","GAT","E","D",3,83298,8,78149,11,161447,1.78214009045335,3955
562,"GAG","GGG","E","G",0,83298,1,78149,1,161447,1.58515760436369,3956
562,"GAG","TAG","E",".",8,83298,9,78149,17,161447,0.748879070324647,3957
563,"AAG","AAG","K","K",82769,82784,78416,78429,161185,161213,1,3958
563,"AAG","AAT","K","N",13,82784,9,78429,22,161213,1.01496337871253,3959
563,"AAG","ACG","K","T",0,82784,1,78429,1,161213,1.58874178350686,3960
563,"AAG","AGG","K","R",0,82784,1,78429,1,161213,1.58874178350686,3961
563,"AAG","ATG","K","M",2,82784,0,78429,2,161213,2.20588094426455,3962
563,"AAG","GAG","K","E",0,82784,2,78429,2,161213,2.29229056879397,3963
564,"CTT","ATT","L","I",7,81799,6,79698,13,161497,0.806270566219466,3964
564,"CTT","CAT","L","H",1,81799,0,79698,1,161497,1.5678013756343,3965
564,"CTT","CCT","L","P",0,81799,4,79698,4,161497,3.25613395754445,3966
564,"CTT","CGT","L","R",0,81799,1,79698,1,161497,1.59919017270258,3967
564,"CTT","CTC","L","L",0,81799,3,79698,3,161497,2.83021018893458,3968
564,"CTT","CTG","L","L",0,81799,1,79698,1,161497,1.59919017270258,3969
564,"CTT","CTT","L","L",81790,81799,79678,79698,161468,161497,1,3970
564,"CTT","TTT","L","F",1,81799,5,79698,6,161497,2.29747435009204,3971
565,"GGA","AGA","G","R",2,80355,2,80990,4,161345,0.685354346386771,3972
565,"GGA","GAA","G","E",0,80355,1,80990,1,161345,1.59694006060415,3973
565,"GGA","GGA","G","G",80339,80355,80970,80990,161309,161345,1,3974
565,"GGA","GGG","G","G",1,80355,3,80990,4,161345,1.59694006060415,3975
565,"GGA","GTA","G","V",7,80355,5,80990,12,161345,1.01604653532629,3976
565,"GGA","TGA","G",".",6,80355,9,80990,15,161345,1.1016518159658,3977
566,"TAC","CAC","Y","H",1,81072,0,82628,1,163700,1.601960051266,3978
566,"TAC","TAA","Y",".",4,81072,5,82628,9,163700,0.869769278339222,3979
566,"TAC","TAC","Y","Y",81045,81072,82598,82628,163643,163700,1,3980
566,"TAC","TAG","Y",".",0,81072,1,82628,1,163700,1.57918498665796,3981
566,"TAC","TAT","Y","Y",15,81072,17,82628,32,163700,0.796822569210484,3982
566,"TAC","TGC","Y","C",7,81072,7,82628,14,163700,0.674346623632538,3983
567,"ACG","AAG","T","K",0,81270,3,82571,3,163841,2.80338485468887,3984
567,"ACG","ACA","T","T",46,81270,39,82571,85,163841,0.854160078091849,3985
567,"ACG","ACC","T","T",3,81270,2,82571,5,163841,1.01034667697292,3986
567,"ACG","ACG","T","T",81186,81270,82484,82571,163670,163841,1,3987
567,"ACG","ACT","T","T",9,81270,4,82571,13,163841,1.60317337893402,3988
567,"ACG","AGG","T","R",0,81270,1,82571,1,163841,1.58414081307385,3989
567,"ACG","ATG","T","M",24,81270,30,82571,54,163841,0.912117559220554,3990
567,"ACG","GCG","T","A",1,81270,8,82571,9,163841,3.02614986167422,3991
567,"ACG","TCG","T","S",1,81270,0,82571,1,163841,1.60317337893402,3992
568,"CAC","AAC","H","N",6,80714,10,83248,16,163962,1.20036041324721,3993
568,"CAC","CAA","H","Q",6,80714,5,83248,11,163962,0.833407806757059,3994
568,"CAC","CAC","H","H",80696,80714,83230,83248,163926,163962,1,3995
568,"CAC","CAT","H","H",3,80714,2,83248,5,163962,0.999827853301971,3996
568,"CAC","GAC","H","D",1,80714,0,83248,1,163962,1.59737264852434,3997
568,"CAC","TAC","H","Y",2,80714,1,83248,3,163962,1.16003224830475,3998
569,"AAA","AAA","K","K",80683,80689,83960,83966,164643,164655,1,3999
569,"AAA","AAC","K","N",0,80689,1,83966,1,164655,1.54625381549671,4000
569,"AAA","AAG","K","K",1,80689,1,83966,2,164655,0.654127358664611,4001
569,"AAA","AAT","K","N",2,80689,0,83966,2,164655,2.29490198246732,4002
569,"AAA","ACA","K","T",1,80689,0,83966,1,164655,1.59401220384911,4003
569,"AAA","GAA","K","E",2,80689,4,83966,6,164655,1.27121336792755,4004
570,"GAG","CAG","E","Q",0,79900,2,85063,2,164963,2.19045451890278,4005
570,"GAG","GAA","E","E",1,79900,0,85063,1,164963,1.58558399565288,4006
570,"GAG","GAC","E","D",1,79900,0,85063,1,164963,1.58558399565288,4007
570,"GAG","GAG","E","E",79880,79900,85049,85063,164929,164963,1,4008
570,"GAG","GAT","E","D",9,79900,4,85063,13,164963,1.58558399565288,4009
570,"GAG","GGG","E","G",1,79900,2,85063,3,164963,1.0935390465979,4010
570,"GAG","TAG","E",".",8,79900,6,85063,14,164963,0.930273681240755,4011
571,"ACA","AAA","T","K",3,79269,3,84763,6,164032,0.628338153185545,4012
571,"ACA","ACA","T","T",79258,79269,84755,84763,164013,164032,1,4013
571,"ACA","ACG","T","T",1,79269,1,84763,2,164032,0.628338153185545,4014
571,"ACA","ACT","T","T",2,79269,1,84763,3,164032,1.13927198822726,4015
571,"ACA","AGA","T","R",1,79269,0,84763,1,164032,1.58401607224891,4016
571,"ACA","ATA","T","I",2,79269,1,84763,3,164032,1.13927198822726,4017
571,"ACA","GCA","T","A",2,79269,1,84763,3,164032,1.13927198822726,4018
571,"ACA","TCA","T","S",0,79269,1,84763,1,164032,1.50362651238766,4019
572,"AAC","AAC","N","N",79218,79219,85127,85138,164345,164357,1,4021
572,"AAC","ATC","N","I",1,79219,0,85138,1,164357,1.58227058857763,4022
572,"AAC","CAC","N","H",0,79219,1,85138,1,164357,1.49603800548592,4023
572,"AAC","GAC","N","D",0,79219,2,85138,2,164357,2.17406142495123,4024
573,"TAC","AAC","Y","N",0,80718,1,86044,1,166762,1.50845918979385,4025
573,"TAC","CAC","Y","H",1,80718,2,86044,3,166762,1.09187824891413,4026
573,"TAC","TAA","Y",".",5,80718,2,86044,7,166762,1.58513299294574,4027
573,"TAC","TAC","Y","Y",80708,80718,86038,86044,166746,166762,1,4028
573,"TAC","TAT","Y","Y",1,80718,1,86044,2,166762,0.631240038571456,4029
573,"TAC","TCC","Y","S",1,80718,0,86044,1,166762,1.58513299294574,4030
573,"TAC","TGC","Y","C",1,80718,0,86044,1,166762,1.58513299294574,4031
573,"TAC","TTC","Y","F",1,80718,0,86044,1,166762,1.58513299294574,4032
574,"ATT","ACT","I","T",0,80950,1,85103,1,166053,1.5303358119008,4033
574,"ATT","ATC","I","I",0,80950,1,85103,1,166053,1.5303358119008,4034
574,"ATT","ATT","I","I",80950,80950,85096,85103,166046,166053,1,4035
574,"ATT","GTT","I","V",0,80950,5,85103,5,166053,3.51385772740467,4036
575,"GAC","GAA","D","E",4,80849,2,85340,6,166189,1.30160706976043,4037
575,"GAC","GAC","D","D",80835,80849,85330,85340,166165,166189,1,4038
575,"GAC","GAT","D","D",0,80849,1,85340,1,166189,1.52381069390834,4039
575,"GAC","GGC","D","G",4,80849,3,85340,7,166189,0.900129010557312,4040
575,"GAC","TAC","D","Y",6,80849,4,85340,10,166189,1.04991927601737,4041
576,"TAC","AAC","Y","N",1,81111,0,86272,1,167383,1.58595674028243,4042
576,"TAC","CAC","Y","H",1,81111,1,86272,2,167383,0.633376914256285,4043
576,"TAC","TAA","Y",".",2,81111,3,86272,5,167383,0.944484600062753,4044
576,"TAC","TAC","Y","Y",81100,81111,86259,86272,167359,167383,1,4045
576,"TAC","TAG","Y",".",0,81111,1,86272,1,167383,1.51201190357589,4046
576,"TAC","TAT","Y","Y",4,81111,8,86272,12,167383,1.35171231573322,4047
576,"TAC","TCC","Y","S",1,81111,0,86272,1,167383,1.58595674028243,4048
576,"TAC","TTC","Y","F",2,81111,0,86272,2,167383,2.29091342601562,4049
577,"TTG","ATG","L","M",1,80897,1,87708,2,168605,0.615555204642022,4050
577,"TTG","CTG","L","L",1,80897,0,87708,1,168605,1.5791196893656,4051
577,"TTG","GTG","L","V",0,80897,1,87708,1,168605,1.48222600470438,4052
577,"TTG","TAG","L",".",2,80897,1,87708,3,168605,1.13162267510763,4053
577,"TTG","TCG","L","S",1,80897,3,87708,4,168605,1.48222600470438,4054
577,"TTG","TGG","L","W",1,80897,0,87708,1,168605,1.5791196893656,4055
577,"TTG","TTA","L","L",1,80897,1,87708,2,168605,0.615555204642022,4056
577,"TTG","TTG","L","L",80886,80897,87698,87708,168584,168605,1,4057
577,"TTG","TTT","L","F",4,80897,3,87708,7,168605,0.880946963858066,4058
578,"TGC","TAC","C","Y",14,80558,14,87538,28,168096,0.613607396470251,4059
578,"TGC","TCC","C","S",1,80558,0,87538,1,168096,1.57837698869208,4060
578,"TGC","TGA","C",".",7,80558,11,87538,18,168096,1.066755454253,4061
578,"TGC","TGC","C","C",80502,80558,87467,87538,167969,168096,1,4062
578,"TGC","TGT","C","C",31,80558,41,87538,72,168096,0.899849128799863,4063
578,"TGC","TTC","C","F",3,80558,5,87538,8,168096,1.066755454253,4064
579,"AAC","AAA","N","K",3,80242,3,88539,6,168781,0.599552254735475,4065
579,"AAC","AAC","N","N",80230,80242,88529,88539,168759,168781,1,4066
579,"AAC","AAT","N","N",7,80242,5,88539,12,168781,0.955157888580696,4067
579,"AAC","ACC","N","T",2,80242,0,88539,2,168781,2.28455381600051,4068
579,"AAC","AGC","N","S",0,80242,1,88539,1,168781,1.45517015450153,4069
579,"AAC","GAC","N","D",0,80242,1,88539,1,168781,1.45517015450153,4070
580,"TCC","ACC","S","T",0,80982,1,87173,1,168155,1.4934916963254,4071
580,"TCC","CCC","S","P",3,80982,4,87173,7,168155,0.853852601544016,4072
580,"TCC","TAC","S","Y",7,80982,15,87173,22,168155,1.4934916963254,4073
580,"TCC","TCA","S","S",8,80982,5,87173,13,168155,1.13563632719866,4074
580,"TCC","TCC","S","S",80962,80982,87144,87173,168106,168155,1,4075
580,"TCC","TCT","S","S",2,80982,2,87173,4,168155,0.622270695432604,4076
580,"TCC","TGC","S","C",0,80982,2,87173,2,168155,2.17115264750549,4077
581,"CAT","AAT","H","N",9,79634,5,86988,14,166622,1.2853029310968,4078
581,"CAT","CAC","H","H",2,79634,3,86988,5,166622,0.912182993333194,4079
581,"CAT","CAT","H","H",79620,79634,86977,86988,166597,166622,1,4080
581,"CAT","CGT","H","R",1,79634,0,86988,1,166622,1.57649838213763,4081
581,"CAT","CTT","H","L",0,79634,1,86988,1,166622,1.47062203578578,4082
581,"CAT","TAT","H","Y",2,79634,2,86988,4,166622,0.608670048188592,4083
582,"CAC","AAC","H","N",10,78710,6,86866,16,165576,1.191012605745,4084
582,"CAC","CAA","H","Q",2,78710,5,86866,7,165576,1.45490923955242,4085
582,"CAC","CAC","H","H",78695,78710,86850,86866,165545,165576,1,4086
582,"CAC","CAG","H","Q",1,78710,0,86866,1,165576,1.57298628215337,4087
582,"CAC","CAT","H","H",2,78710,1,86866,3,165576,1.12201094426288,4088
582,"CAC","CGC","H","R",0,78710,3,86866,3,165576,2.64875150930842,4089
582,"CAC","TAC","H","Y",0,78710,1,86866,1,165576,1.45490923955242,4090
583,"CTG","ATG","L","M",8,79931,5,86235,13,166166,1.13430700468828,4091
583,"CTG","CAG","L","Q",2,79931,2,86235,4,166166,0.620048531774588,4092
583,"CTG","CCG","L","P",8,79931,5,86235,13,166166,1.13430700468828,4093
583,"CTG","CGG","L","R",1,79931,0,86235,1,166166,1.58083641362051,4094
583,"CTG","CTA","L","L",4,79931,8,86235,12,166166,1.33057527841732,4095
583,"CTG","CTG","L","L",79904,79931,86212,86235,166116,166166,1,4096
583,"CTG","CTT","L","L",4,79931,2,86235,6,166166,1.29110308494101,4097
583,"CTG","TTG","L","L",0,79931,1,86235,1,166166,1.48976953563955,4098
584,"TAC","AAC","Y","N",0,81051,2,87078,2,168129,2.17436179210188,4099
584,"TAC","CAC","Y","H",1,81051,1,87078,2,168129,0.623950079311578,4100
584,"TAC","TAA","Y",".",3,81051,4,87078,7,168129,0.855933773607171,4101
584,"TAC","TAC","Y","Y",81038,81051,87068,87078,168106,168129,1,4102
584,"TAC","TAT","Y","Y",5,81051,3,87078,8,168129,1.13664174021287,4103
584,"TAC","TGC","Y","C",2,81051,0,87078,2,168129,2.28912343779787,4104
584,"TAC","TTC","Y","F",2,81051,0,87078,2,168129,2.28912343779787,4105
585,"AGG","AAG","R","K",0,81255,3,87397,3,168652,2.69688022186199,4106
585,"AGG","ACG","R","T",0,81255,1,87397,1,168652,1.49477776673953,4107
585,"AGG","AGA","R","R",1,81255,0,87397,1,168652,1.58198169918018,4108
585,"AGG","AGG","R","R",81230,81255,87360,87397,168590,168652,1,4109
585,"AGG","AGT","R","S",6,81255,9,87397,15,168652,1.01684606499981,4110
585,"AGG","ATG","R","M",8,81255,10,87397,18,168652,0.829225243867388,4111
585,"AGG","CGG","R","R",0,81255,2,87397,2,168652,2.17262192241528,4112
585,"AGG","GGG","R","G",7,81255,7,87397,14,168652,0.623039265775713,4113
585,"AGG","TGG","R","W",3,81255,5,87397,8,168652,1.08021727579097,4114
586,"GAT","AAT","D","N",2,81676,1,88345,3,170021,1.13292334211644,4115
586,"GAT","CAT","D","H",1,81676,1,88345,2,170021,0.617733419754718,4116
586,"GAT","GAA","D","E",0,81676,1,88345,1,170021,1.48588573052104,4117
586,"GAT","GAC","D","D",2,81676,1,88345,3,170021,1.13292334211644,4118
586,"GAT","GAT","D","D",81661,81676,88329,88345,169990,170021,1,4119
586,"GAT","GGT","D","G",1,81676,1,88345,2,170021,0.617733419754718,4120
586,"GAT","TAT","D","Y",9,81676,11,88345,20,170021,0.802358446138546,4121
587,"AAA","AAA","K","K",80911,80918,85979,85981,166890,166899,1,4122
587,"AAA","AAG","K","K",0,80918,1,85981,1,166899,1.5134436250293,4123
587,"AAA","AGA","K","R",1,80918,0,85981,1,166899,1.5862893411769,4124
587,"AAA","ATA","K","I",2,80918,0,85981,2,166899,2.29107778791387,4125
587,"AAA","CAA","K","Q",0,80918,1,85981,1,166899,1.5134436250293,4126
587,"AAA","GAA","K","E",3,80918,0,85981,3,166899,2.82646038863335,4127
587,"AAA","TAA","K",".",1,80918,0,85981,1,166899,1.5862893411769,4128
588,"CAT","AAT","H","N",7,80370,5,85188,12,165558,0.981239955233319,4129
588,"CAT","CAA","H","Q",1,80370,0,85188,1,165558,1.58718909688566,4130
588,"CAT","CAC","H","H",0,80370,3,85188,3,165558,2.72390708791374,4131
588,"CAT","CAT","H","H",80356,80370,85178,85188,165534,165558,1,4132
588,"CAT","CCT","H","P",1,80370,0,85188,1,165558,1.58718909688566,4133
588,"CAT","TAT","H","Y",5,80370,2,85188,7,165558,1.58718909688566,4134
589,"TAC","CAC","Y","H",2,81427,0,85223,2,166650,2.29382266696829,4135
589,"TAC","TAA","Y",".",0,81427,3,85223,3,166650,2.7475360293081,4136
589,"TAC","TAC","Y","Y",81413,81427,85215,85223,166628,166650,1,4137
589,"TAC","TAT","Y","Y",4,81427,3,85223,7,166650,0.906344843674389,4138
589,"TAC","TGC","Y","C",7,81427,1,85223,8,166650,2.82806827920085,4139
589,"TAC","TTT","Y","F",1,81427,1,85223,2,166650,0.648546452194394,4140
590,"TTT","GTT","F","V",3,79595,0,83777,3,163372,2.82746791370893,4141
590,"TTT","TAT","F","Y",1,79595,1,83777,2,163372,0.643225435826396,4142
590,"TTT","TGT","F","C",1,79595,1,83777,2,163372,0.643225435826396,4143
590,"TTT","TTC","F","F",0,79595,1,83777,1,163372,1.52832132964718,4144
590,"TTT","TTT","F","F",79590,79595,83774,83777,163364,163372,1,4145
591,"GTG","ATG","V","M",1,81360,1,83636,2,164996,0.665803033128355,4146
591,"GTG","GAG","V","E",0,81360,1,83636,1,164996,1.56532102803376,4147
591,"GTG","GTA","V","V",0,81360,2,83636,2,164996,2.25281419170182,4148
591,"GTG","GTG","V","V",81339,81360,83626,83636,164965,164996,1,4149
591,"GTG","GTT","V","V",14,81360,5,83636,19,164996,1.97353263106644,4150
591,"GTG","TTG","V","L",6,81360,1,83636,7,164996,2.57991774235317,4151
592,"AGG","AAG","R","K",5,80579,3,84271,8,164850,1.15187697042972,4152
592,"AGG","AGA","R","R",0,80579,3,84271,3,164850,2.74893753601328,4153
592,"AGG","AGG","R","R",80537,80579,84235,84271,164772,164850,1,4154
592,"AGG","AGT","R","S",7,80579,7,84271,14,164850,0.649261284092646,4155
592,"AGG","ATG","R","M",15,80579,10,84271,25,164850,1.10850611310599,4156
592,"AGG","CGG","R","R",0,80579,1,84271,1,164850,1.53826521919829,4157
592,"AGG","GGG","R","G",13,80579,12,84271,25,164850,0.729425889813341,4158
592,"AGG","TGG","R","W",2,80579,0,84271,2,164850,2.29396064019304,4159
593,"GGT","AGT","G","S",4,79940,6,84956,10,164896,1.00636798262444,4160
593,"GGT","GAT","G","D",1,79940,4,84956,5,164896,1.87710941466557,4161
593,"GGT","GCT","G","A",1,79940,0,84956,1,164896,1.58627863467291,4162
593,"GGT","GGC","G","G",0,79940,2,84956,2,164896,2.19386424880409,4163
593,"GGT","GGG","G","G",0,79940,1,84956,1,164896,1.51339756206904,4164
593,"GGT","GGT","G","G",79929,79940,84938,84956,164867,164896,1,4165
593,"GGT","GTT","G","V",3,79940,2,84956,5,164896,0.979570452699854,4166
593,"GGT","TGT","G","C",2,79940,3,84956,5,164896,0.945571057332614,4167
594,"GGC","AGC","G","S",4,78446,3,82229,7,160675,0.905385812792044,4168
594,"GGC","CGC","G","R",0,78446,1,82229,1,160675,1.53504690578,4169
594,"GGC","GAC","G","D",52,78446,62,82229,114,160675,0.826951074313729,4170
594,"GGC","GCC","G","A",0,78446,1,82229,1,160675,1.53504690578,4171
594,"GGC","GGA","G","G",9,78446,9,82229,18,160675,0.647305216431814,4172
594,"GGC","GGC","G","G",78355,78446,82121,82229,160476,160675,1,4173
594,"GGC","GGG","G","G",1,78446,0,82229,1,160675,1.59135251509696,4174
594,"GGC","GGT","G","G",13,78446,21,82229,34,160675,1.17806884664055,4175
594,"GGC","GTC","G","V",8,78446,6,82229,14,160675,0.94135285062903,4176
594,"GGC","TGC","G","C",4,78446,5,82229,9,160675,0.837661104114524,4177
595,"ATG","ACG","M","T",3,77949,2,81188,5,159137,0.993041976845206,4178
595,"ATG","ATA","M","I",6,77949,9,81188,15,159137,1.05811325218959,4179
595,"ATG","ATG","M","M",77914,77949,81158,81188,159072,159137,1,4180
595,"ATG","ATT","M","I",20,77949,17,81188,37,159137,0.825388278720018,4181
595,"ATG","CTG","M","L",3,77949,0,81188,3,159137,2.82859421180073,4182
595,"ATG","GTG","M","V",3,77949,2,81188,5,159137,0.993041976845206,4183
596,"CCC","ACC","P","T",9,80338,6,80433,15,160771,1.11128347849705,4184
596,"CCC","CAC","P","H",2,80338,7,80433,9,160771,2.09098716878919,4185
596,"CCC","CCA","P","P",9,80338,9,80433,18,160771,0.691865911085375,4186
596,"CCC","CCC","P","P",80285,80338,80388,80433,160673,160771,1,4187
596,"CCC","CCT","P","P",2,80338,1,80433,3,160771,1.17786671711625,4188
596,"CCC","CGC","P","R",0,80338,1,80433,1,160771,1.60738709254096,4189
596,"CCC","CTC","P","L",2,80338,2,80433,4,160771,0.691865911085375,4190
596,"CCC","GCC","P","A",1,80338,0,80433,1,160771,1.60892560162561,4191
596,"CCC","TCC","P","S",28,80338,19,80433,47,160771,1.13138246678247,4192
597,"TCG","CCG","S","P",3,78337,5,79046,8,157383,1.1662112214007,4193
597,"TCG","TAG","S",".",9,78337,5,79046,14,157383,1.32439629972124,4194
597,"TCG","TCA","S","S",3,78337,6,79046,9,157383,1.38824112876736,4195
597,"TCG","TCC","S","S",0,78337,1,79046,1,157383,1.59504444594577,4196
597,"TCG","TCG","S","S",78316,78337,79025,79046,157341,157383,1,4197
597,"TCG","TCT","S","S",2,78337,2,79046,4,157383,0.684175570908645,4198
597,"TCG","TTG","S","L",4,78337,2,79046,6,157383,1.32439629972124,4199
598,"GGA","AGA","G","R",1,77576,2,78666,3,156242,1.15938068637957,4200
598,"GGA","CGA","G","R",1,77576,0,78666,1,156242,1.60390783357231,4201
598,"GGA","GAA","G","E",0,77576,2,78666,2,156242,2.27745529548327,4202
598,"GGA","GCA","G","A",0,77576,1,78666,1,156242,1.58713170400911,4203
598,"GGA","GGA","G","G",77562,77576,78654,78666,156216,156242,1,4204
598,"GGA","GTA","G","V",5,77576,5,78666,10,156242,0.679264216319412,4205
598,"GGA","TGA","G",".",7,77576,2,78666,9,156242,2.08982952804666,4206
599,"TGT","CGT","C","R",0,78117,2,78650,2,156767,2.29039820110984,4207
599,"TGT","GGT","C","G",1,78117,0,78650,1,156767,1.60674252035589,4208
599,"TGT","TAT","C","Y",2,78117,3,78650,5,156767,1.01300029484693,4209
599,"TGT","TGC","C","C",0,78117,3,78650,3,156767,2.82046531317816,4210
599,"TGT","TGT","C","C",78109,78117,78640,78650,156749,156767,1,4211
599,"TGT","TTT","C","F",5,78117,2,78650,7,156767,1.60674252035589,4212
600,"TCT","CCT","S","P",2,79664,1,78922,3,158586,1.16581882303289,4213
600,"TCT","GCT","S","A",1,79664,0,78922,1,158586,1.59459010883569,4214
600,"TCT","TAT","S","Y",15,79664,15,78922,30,158586,0.683893169919892,4215
600,"TCT","TCC","S","S",3,79664,3,78922,6,158586,0.683893169919892,4216
600,"TCT","TCT","S","S",79639,79664,78902,78922,158541,158586,1,4217
600,"TCT","TTT","S","F",4,79664,1,78922,5,158586,1.96499241180577,4218
601,"GGT","AGT","G","S",8,80171,3,78257,11,158428,1.76188027519265,4219
601,"GGT","GAT","G","D",1,80171,4,78257,5,158428,1.97446508552464,4220
601,"GGT","GGC","G","G",0,80171,2,78257,2,158428,2.29785047832337,4221
601,"GGT","GGT","G","G",80157,80171,78241,78257,158398,158428,1,4222
601,"GGT","GTT","G","V",1,80171,5,78257,6,158428,2.29785047832337,4223
601,"GGT","TGT","G","C",4,80171,2,78257,6,158428,1.29378742594191,4224
602,"ACC","AAC","T","N",1,80816,1,78032,2,158848,0.658749482270286,4225
602,"ACC","ACA","T","T",4,80816,3,78032,7,158848,0.89887390725625,4226
602,"ACC","ACC","T","T",80802,80816,78022,78032,158824,158848,1,4227
602,"ACC","ACT","T","T",2,80816,3,78032,5,158848,0.997004770674203,4228
602,"ACC","ATC","T","I",7,80816,3,78032,10,158848,1.55381894270459,4229
603,"AGT","AAT","S","N",25,80451,25,79175,50,159626,0.677268326462146,4230
603,"AGT","ACT","S","T",0,80451,1,79175,1,159626,1.60311659504761,4231
603,"AGT","AGA","S","R",0,80451,1,79175,1,159626,1.60311659504761,4232
603,"AGT","AGC","S","S",2,80451,2,79175,4,159626,0.677268326462146,4233
603,"AGT","AGT","S","S",80417,80451,79140,79175,159557,159626,1,4234
603,"AGT","ATT","S","I",1,80451,5,79175,6,159626,2.29942942917417,4235
603,"AGT","CGT","S","R",0,80451,1,79175,1,159626,1.60311659504761,4236
603,"AGT","GGT","S","G",5,80451,0,79175,5,159626,3.57978284626364,4237
603,"AGT","TGT","S","C",1,80451,0,79175,1,159626,1.58390929292902,4238
604,"ATT","ACT","I","T",0,79214,1,80066,1,159280,1.5923572900989,4239
604,"ATT","AGT","I","S",1,79214,0,80066,1,159280,1.60519503024867,4240
604,"ATT","ATT","I","I",79212,79214,80064,80066,159276,159280,1,4241
604,"ATT","GTT","I","V",1,79214,1,80066,2,159280,0.682506029104683,4242
605,"TTC","CTC","F","L",1,79312,2,78994,3,158306,1.17618912890498,4243
605,"TTC","TAC","F","Y",1,79312,0,78994,1,158306,1.60301396582541,4244
605,"TTC","TCC","F","S",2,79312,1,78994,3,158306,1.17309821922613,4245
605,"TTC","TTA","F","L",10,79312,8,78994,18,158306,0.909012418861075,4246
605,"TTC","TTC","F","F",79298,79312,78980,78994,158278,158306,1,4247
605,"TTC","TTG","F","L",0,79312,1,78994,1,158306,1.60783579042782,4248
605,"TTC","TTT","F","F",0,79312,2,78994,2,158306,2.30178435284023,4249
606,"AAC","AAA","N","K",2,80600,4,78255,6,158855,1.31383335901312,4250
606,"AAC","AAC","N","N",80594,80600,78248,78255,158842,158855,1,4251
606,"AAC","AAT","N","N",2,80600,1,78255,3,158855,1.1381272411409,4252
606,"AAC","GAC","N","D",1,80600,2,78255,3,158855,1.1608451206559,4253
606,"AAC","TTC","N","F",1,80600,0,78255,1,158855,1.56245556024073,4254
607,"TCA","ACA","S","T",2,80646,0,78634,2,159280,2.25725584700768,4255
607,"TCA","CCA","S","P",10,80646,4,78634,14,159280,1.72306509138197,4256
607,"TCA","TAA","S",".",12,80646,16,78634,28,159280,0.978633523222072,4257
607,"TCA","TCA","S","S",80620,80646,78610,78634,159230,159280,1,4258
607,"TCA","TCG","S","S",1,80646,0,78634,1,159280,1.56924791752113,4259
607,"TCA","TGA","S",".",0,80646,1,78634,1,159280,1.5995408252886,4260
607,"TCA","TTA","S","L",1,80646,3,78634,4,159280,1.5995408252886,4261
608,"ATG","AAG","M","K",0,80590,2,78887,2,159477,2.29839652187748,4262
608,"ATG","ATA","M","I",0,80590,2,78887,2,159477,2.29839652187748,4263
608,"ATG","ATG","M","M",80578,80590,78876,78887,159454,159477,1,4264
608,"ATG","ATT","M","I",10,80590,5,78887,15,159477,1.43998274973726,4265
608,"ATG","GTG","M","V",2,80590,2,78887,4,159477,0.672026647642689,4266
609,"ATT","ATA","I","I",0,80316,2,78975,2,159291,2.2992632113418,4267
609,"ATT","ATC","I","I",1,80316,0,78975,1,159291,1.58254865245584,4268
609,"ATT","ATT","I","I",80314,80316,78971,78975,159285,159291,1,4269
609,"ATT","GTT","I","V",1,80316,1,78975,2,159291,0.676426311196438,4270
609,"ATT","TTT","I","F",0,80316,1,78975,1,159291,1.60278307744285,4271
610,"AAC","AAA","N","K",3,82116,3,78770,6,160886,0.652467951830213,4272
610,"AAC","AAC","N","N",82106,82116,78765,78770,160871,160886,1,4273
610,"AAC","AAT","N","N",2,82116,1,78770,3,160886,1.12187845094471,4274
610,"AAC","GAC","N","D",2,82116,1,78770,3,160886,1.12187845094471,4275
610,"AAC","TAC","N","Y",2,82116,0,78770,2,160886,2.22812737018912,4276
610,"AAC","TTC","N","F",1,82116,0,78770,1,160886,1.54353238153328,4277
611,"AAT","AAG","N","K",0,83715,1,78129,1,161844,1.58329460053182,4278
611,"AAT","AAT","N","N",83714,83715,78127,78129,161841,161844,1,4279
611,"AAT","ACT","N","T",0,83715,1,78129,1,161844,1.58329460053182,4280
611,"AAT","TAT","N","Y",1,83715,0,78129,1,161844,1.50049528109245,4281
612,"ATC","ACC","I","T",2,84067,0,77690,2,161757,2.16193500062667,4282
612,"ATC","ATA","I","I",10,84067,6,77690,16,161757,1.13442572656242,4283
612,"ATC","ATC","I","I",84051,84067,77683,77690,161734,161757,1,4284
612,"ATC","ATG","I","M",1,84067,0,77690,1,161757,1.48542879077633,4285
612,"ATC","ATT","I","I",1,84067,1,77690,2,161757,0.617461279632739,4286
612,"ATC","GTC","I","V",1,84067,0,77690,1,161757,1.48542879077633,4287
612,"ATC","TTC","I","F",1,84067,0,77690,1,161757,1.48542879077633,4288
613,"ATA","AAA","I","K",3,83744,2,78190,5,161934,0.936035412768066,4289
613,"ATA","ACA","I","T",0,83744,1,78190,1,161934,1.583461813062,4290
613,"ATA","ATA","I","I",83737,83744,78185,78190,161922,161934,1,4291
613,"ATA","ATG","I","M",1,83744,0,78190,1,161934,1.50122166575506,4292
613,"ATA","GTA","I","V",2,83744,1,78190,3,161934,1.08570661504957,4293
613,"ATA","TTA","I","L",1,83744,1,78190,2,161934,0.626896199619624,4294
614,"ATT","ACT","I","T",0,85074,1,77869,1,162943,1.57645737785048,4295
614,"ATT","AGT","I","S",1,85074,0,77869,1,162943,1.47043968759346,4296
614,"ATT","ATA","I","I",1,85074,2,77869,3,162943,1.12745464227187,4297
614,"ATT","ATT","I","I",85071,85074,77866,77869,162937,162943,1,4298
614,"ATT","GTT","I","V",1,85074,0,77869,1,162943,1.47043968759346,4299
615,"AGG","AAG","R","K",1,85661,0,77205,1,162866,1.44661271452461,4300
615,"AGG","ACG","R","T",1,85661,0,77205,1,162866,1.44661271452461,4301
615,"AGG","AGA","R","R",1,85661,0,77205,1,162866,1.44661271452461,4302
615,"AGG","AGG","R","R",85643,85661,77182,77205,162825,162866,1,4303
615,"AGG","AGT","R","S",2,85661,15,77205,17,162866,3.37610584155029,4304
615,"AGG","ATG","R","M",8,85661,6,77205,14,162866,0.851250497401264,4305
615,"AGG","GGG","R","G",4,85661,2,77205,6,162866,1.18051193751672,4306
615,"AGG","TGG","R","W",1,85661,0,77205,1,162866,1.44661271452461,4307
616,"ACA","AAA","T","K",2,86285,6,76909,8,163194,1.83079888120565,4308
616,"ACA","ACA","T","T",86277,86285,76899,76909,163176,163194,1,4309
616,"ACA","ACG","T","T",0,86285,1,76909,1,163194,1.56745364664817,4310
616,"ACA","ACT","T","T",1,86285,0,76909,1,163194,1.42976022275844,4311
616,"ACA","AGA","T","R",1,86285,0,76909,1,163194,1.42976022275844,4312
616,"ACA","ATA","T","I",2,86285,0,76909,2,163194,2.09799572441862,4313
616,"ACA","CCA","T","P",0,86285,1,76909,1,163194,1.56745364664817,4314
616,"ACA","GCA","T","A",2,86285,2,76909,4,163194,0.584684267867849,4315
617,"CTA","ATA","L","I",2,87257,4,77903,6,165160,1.27388916327131,4316
617,"CTA","CAA","L","Q",0,87257,2,77903,2,165160,2.28207116240701,4317
617,"CTA","CCA","L","P",5,87257,3,77903,8,165160,1.02716590788625,4318
617,"CTA","CTA","L","L",87248,87257,77888,77903,165136,165160,1,4319
617,"CTA","CTC","L","L",0,87257,1,77903,1,165160,1.56798040070788,4320
617,"CTA","CTG","L","L",0,87257,1,77903,1,165160,1.56798040070788,4321
617,"CTA","GTA","L","V",1,87257,0,77903,1,165160,1.43217600108122,4322
617,"CTA","TTA","L","L",1,87257,4,77903,5,165160,1.95259496814213,4323
618,"ATG","ATA","M","I",5,87397,6,77884,11,165281,0.767840417089359,4324
618,"ATG","ATG","M","M",87381,87397,77862,77884,165243,165281,1,4325
618,"ATG","ATT","M","I",8,87397,14,77884,22,165281,1.27306232363225,4326
618,"ATG","GTG","M","V",2,87397,2,77884,4,165281,0.584445523452809,4327
618,"ATG","TTG","M","L",1,87397,0,77884,1,165281,1.42935000106601,4328
619,"CTA","ATA","L","I",4,89060,12,77921,16,166981,2.01826360278948,4329
619,"CTA","CAA","L","Q",0,89060,1,77921,1,166981,1.56134932275558,4330
619,"CTA","CCA","L","P",3,89060,4,77921,7,166981,0.844900746035288,4331
619,"CTA","CTA","L","L",89053,89060,77902,77921,166955,166981,1,4332
619,"CTA","TTA","L","L",0,89060,2,77921,2,166981,2.27882983436356,4333
620,"AAA","AAA","K","K",89980,89981,78301,78305,168281,168286,1,4334
620,"AAA","AAC","K","N",0,89981,1,78305,1,168286,1.55967152850851,4335
620,"AAA","AAG","K","K",1,89981,1,78305,2,168286,0.56375484718241,4336
620,"AAA","ACA","K","T",0,89981,1,78305,1,168286,1.55967152850851,4337
620,"AAA","GAA","K","E",0,89981,1,78305,1,168286,1.55967152850851,4338
621,"GTG","GTA","V","V",1,90909,1,77810,2,168719,0.549633664045877,4339
621,"GTG","GTG","V","V",90900,90909,77804,77810,168704,168719,1,4340
621,"GTG","GTT","V","V",5,90909,4,77810,9,168719,0.720261337386376,4341
621,"GTG","TTG","V","L",3,90909,1,77810,4,168719,1.36875970491524,4342
622,"TAC","AAA","Y","K",0,91106,1,76478,1,167584,1.54855220825663,4343
622,"TAC","CAC","Y","H",2,91106,1,76478,3,167584,0.949907794434068,4344
622,"TAC","TAA","Y",".",5,91106,3,76478,8,167584,0.949907794434068,4345
622,"TAC","TAC","Y","Y",91097,91106,76470,76478,167567,167584,1,4346
622,"TAC","TAT","Y","Y",1,91106,1,76478,2,167584,0.533362093318077,4347
622,"TAC","TGC","Y","C",1,91106,2,76478,3,167584,1.08338151724274,4348
623,"AAA","AAA","K","K",92811,92819,76548,76555,169359,169374,1,4349
623,"AAA","AAG","K","K",6,92819,5,76555,11,169374,0.655393696208343,4350
623,"AAA","AAT","K","N",2,92819,1,76555,3,169374,0.92844471590562,4351
623,"AAA","ATA","K","I",0,92819,1,76555,1,169374,1.54335227366603,4352
624,"GGG","GAG","G","E",1,94195,1,75742,2,169937,0.498795308848332,4353
624,"GGG","GGA","G","G",0,94195,1,75742,1,169937,1.53616509503248,4354
624,"GGG","GGC","G","G",1,94195,0,75742,1,169937,1.27730088387721,4355
624,"GGG","GGG","G","G",94161,94195,75724,75742,169885,169937,1,4356
624,"GGG","GGT","G","G",12,94195,7,75742,19,169937,0.996132048506051,4357
624,"GGG","GTG","G","V",10,94195,4,75742,14,169937,1.41832668679826,4358
624,"GGG","TGG","G","W",10,94195,5,75742,15,169937,1.15491462658328,4359
625,"ATT","ACT","I","T",1,94181,0,76380,1,170561,1.28950012780975,4360
625,"ATT","ATT","I","I",94175,94181,76377,76380,170552,170561,1,4361
625,"ATT","GTT","I","V",4,94181,3,76380,7,170561,0.706913527267222,4362
625,"ATT","TTT","I","F",1,94181,0,76380,1,170561,1.28950012780975,4363
626,"GAC","AAC","D","N",3,94106,1,77046,4,171152,1.30327412871448,4364
626,"GAC","GAA","D","E",3,94106,3,77046,6,171152,0.513022724266635,4365
626,"GAC","GAC","D","D",94084,94106,77030,77046,171114,171152,1,4366
626,"GAC","GAG","D","E",1,94106,0,77046,1,171152,1.30327412871448,4367
626,"GAC","GAT","D","D",3,94106,1,77046,4,171152,1.30327412871448,4368
626,"GAC","GGC","D","G",2,94106,1,77046,3,171152,0.919584575053632,4369
626,"GAC","TAC","D","Y",10,94106,10,77046,20,171152,0.513022724266635,4370
627,"TTG","CTG","L","L",1,96911,0,76692,1,173603,1.25431021631156,4371
627,"TTG","TAG","L",".",1,96911,0,76692,1,173603,1.25431021631156,4372
627,"TTG","TCG","L","S",1,96911,3,76692,4,173603,1.531769277197,4373
627,"TTG","TGG","L","W",1,96911,0,76692,1,173603,1.25431021631156,4374
627,"TTG","TTA","L","L",1,96911,0,76692,1,173603,1.25431021631156,4375
627,"TTG","TTC","L","F",0,96911,1,76692,1,173603,1.531769277197,4376
627,"TTG","TTG","L","L",96895,96911,76685,76692,173580,173603,1,4377
627,"TTG","TTT","L","F",11,96911,3,76692,14,173603,1.89268928496991,4378
628,"GAC","AAC","D","N",1,96942,2,77029,3,173971,1.05824250376693,4379
628,"GAC","GAA","D","E",3,96942,4,77029,7,173971,0.785636411690058,4380
628,"GAC","GAC","D","D",96911,96942,77000,77029,173911,173971,1,4381
628,"GAC","GAG","D","E",0,96942,1,77029,1,173971,1.53283818019314,4382
628,"GAC","GAT","D","D",2,96942,2,77029,4,173971,0.489378872467783,4383
628,"GAC","GGC","D","G",6,96942,2,77029,8,173971,1.48999926332287,4384
628,"GAC","TAC","D","Y",19,96942,18,77029,37,173971,0.530336638215203,4385
629,"CAA","AAA","Q","K",5,96022,6,76424,11,172446,0.690411230692201,4386
629,"CAA","CAA","Q","Q",96011,96022,76413,76424,172424,172446,1,4387
629,"CAA","CAG","Q","Q",1,96022,0,76424,1,172446,1.26234487816947,4388
629,"CAA","CGA","Q","R",1,96022,0,76424,1,172446,1.26234487816947,4389
629,"CAA","CTA","Q","L",0,96022,2,76424,2,172446,2.26523876672593,4390
629,"CAA","TAA","Q",".",4,96022,3,76424,7,172446,0.687996805551573,4391
630,"TTC","GTC","F","V",0,96253,1,76830,1,173083,1.53410288866826,4392
630,"TTC","TAC","F","Y",1,96253,0,76830,1,173083,1.26656850218175,4393
630,"TTC","TCC","F","S",0,96253,1,76830,1,173083,1.53410288866826,4394
630,"TTC","TTA","F","L",10,96253,6,76830,16,173083,0.945229543858189,4395
630,"TTC","TTC","F","F",96240,96253,76821,76830,173061,173083,1,4396
630,"TTC","TTG","F","L",1,96253,0,76830,1,173083,1.26656850218175,4397
630,"TTC","TTT","F","F",1,96253,1,76830,2,173083,0.492965239245704,4398
631,"AGG","AAG","R","K",1,96905,1,78380,2,175285,0.503299645828846,4399
631,"AGG","AGA","R","R",2,96905,4,78380,6,175285,1.23312809700791,4400
631,"AGG","AGC","R","S",1,96905,0,78380,1,175285,1.2855569780794,4401
631,"AGG","AGG","R","R",96865,96905,78345,78380,175210,175285,1,4402
631,"AGG","AGT","R","S",6,96905,7,78380,13,175285,0.673093901457044,4403
631,"AGG","ATG","R","M",12,96905,8,78380,20,175285,0.860724808420116,4404
631,"AGG","CGG","R","R",3,96905,2,78380,5,175285,0.771482135225859,4405
631,"AGG","GGG","R","G",14,96905,12,78380,26,175285,0.626439370925752,4406
631,"AGG","TGG","R","W",1,96905,1,78380,2,175285,0.503299645828846,4407
632,"ATG","ATA","M","I",1,96577,3,78776,4,175353,1.54016775663893,4408
632,"ATG","ATG","M","M",96561,96577,78765,78776,175326,175353,1,4409
632,"ATG","ATT","M","I",11,96577,6,78776,17,175353,1.08362772693209,4410
632,"ATG","GTG","M","V",2,96577,2,78776,4,175353,0.510049033866348,4411
632,"ATG","TTG","M","L",2,96577,0,78776,2,175353,1.94424528873325,4412
633,"ATC","ATA","I","I",10,97513,6,79189,16,176702,0.966516946509751,4413
633,"ATC","ATC","I","I",97491,97513,79177,79189,176668,176702,1,4414
633,"ATC","ATT","I","I",8,97513,4,79189,12,176702,1.14328509866806,4415
633,"ATC","CTC","I","L",1,97513,0,79189,1,176702,1.29152807594706,4416
633,"ATC","GTC","I","V",2,97513,1,79189,3,176702,0.909897281175475,4417
633,"ATC","TTC","I","F",1,97513,1,79189,2,176702,0.506567868322771,4418
634,"GCA","ACA","A","T",50,95930,31,79426,81,175356,1.00861521135534,4419
634,"GCA","GAA","A","E",12,95930,8,79426,20,175356,0.888194719260638,4420
634,"GCA","GCA","A","A",95859,95930,79380,79426,175239,175356,1,4421
634,"GCA","GGA","A","G",1,95930,1,79426,2,175356,0.522203511440345,4422
634,"GCA","GTA","A","V",0,95930,2,79426,2,175356,2.27065450493907,4423
634,"GCA","TCA","A","S",8,95930,4,79426,12,175356,1.16993755731919,4424
635,"TAT","CAT","Y","H",1,97091,3,79619,4,176710,1.54167820901435,4425
635,"TAT","TAT","Y","Y",97085,97091,79611,79619,176696,176710,1,4426
635,"TAT","TGT","Y","C",5,97091,4,79619,9,176710,0.677166162154263,4427
635,"TAT","TTT","Y","F",0,97091,1,79619,1,176710,1.54167820901435,4428
636,"GGT","AGT","G","S",3,95983,2,79789,5,175772,0.801380961940034,4429
636,"GGT","GAT","G","D",4,95983,2,79789,6,175772,1.07148538741017,4430
636,"GGT","GCT","G","A",1,95983,0,79789,1,175772,1.32558502927899,4431
636,"GGT","GGC","G","G",0,95983,1,79789,1,175772,1.54566640306951,4432
636,"GGT","GGT","G","G",95969,95983,79781,79789,175750,175772,1,4433
636,"GGT","GTT","G","V",2,95983,1,79789,3,175772,0.938039574059832,4434
636,"GGT","TGT","G","C",4,95983,2,79789,6,175772,1.07148538741017,4435
637,"GAT","AAT","D","N",5,95135,1,79290,6,174425,1.98122259720036,4436
637,"GAT","CAT","D","H",0,95135,1,79290,1,174425,1.54641772504128,4437
637,"GAT","GAC","D","D",2,95135,0,79290,2,174425,1.98122259720036,4438
637,"GAT","GAT","D","D",95118,95135,79275,79290,174393,174425,1,4439
637,"GAT","GGT","D","G",1,95135,3,79290,4,174425,1.54641772504128,4440
637,"GAT","TAT","D","Y",9,95135,10,79290,19,174425,0.644283876247595,4441
638,"GAT","AAT","D","N",5,94374,3,80769,8,175143,0.973893256865138,4442
638,"GAT","CAT","D","H",1,94374,0,80769,1,175143,1.36868903639156,4443
638,"GAT","GAC","D","D",6,94374,5,80769,11,175143,0.691686231021038,4444
638,"GAT","GAT","D","D",94344,94374,80748,80769,175092,175143,1,4445
638,"GAT","GGT","D","G",7,94374,8,80769,15,175143,0.69223363517217,4446
638,"GAT","GTT","D","V",2,94374,0,80769,2,175143,2.02721869589584,4447
638,"GAT","TAT","D","Y",9,94374,5,80769,14,175143,1.11016451103281,4448
639,"GTG","ATG","V","M",6,93487,2,81352,8,174839,1.63377965176002,4449
639,"GTG","CTG","V","L",1,93487,0,81352,1,174839,1.39359051220695,4450
639,"GTG","GTA","V","V",3,93487,2,81352,5,174839,0.852861654955466,4451
639,"GTG","GTG","V","V",93466,93487,81338,81352,174804,174839,1,4452
639,"GTG","GTT","V","V",8,93487,6,81352,14,174839,0.811774752563527,4453
639,"GTG","TTG","V","L",3,93487,4,81352,7,174839,0.841490817611096,4454
640,"ATC","AGC","I","S",1,91920,0,83063,1,174983,1.45078004731312,4455
640,"ATC","ATA","I","I",4,91920,6,83063,10,174983,1.02123087110353,4456
640,"ATC","ATC","I","I",91897,91920,83044,83063,174941,174983,1,4457
640,"ATC","ATG","I","M",1,91920,1,83063,2,174983,0.596972297992742,4458
640,"ATC","ATT","I","I",15,91920,11,83063,26,174983,0.89680273390302,4459
640,"ATC","CTC","I","L",0,91920,1,83063,1,174983,1.57207042565887,4460
640,"ATC","GTC","I","V",2,91920,0,83063,2,174983,2.12220079425538,4461
641,"GCA","ACA","A","T",72,89985,78,83562,150,173547,0.709522863312028,4462
641,"GCA","CCA","A","P",0,89985,1,83562,1,173547,1.58142559501658,4463
641,"GCA","GAA","A","E",3,89985,11,83562,14,173547,2.28867701731937,4464
641,"GCA","GCA","A","A",89899,89985,83460,83562,173359,173547,1,4465
641,"GCA","GCG","A","A",0,89985,1,83562,1,173547,1.58142559501658,4466
641,"GCA","GGA","A","G",0,89985,1,83562,1,173547,1.58142559501658,4467
641,"GCA","GTA","A","V",1,89985,5,83562,6,173547,2.28867701731937,4468
641,"GCA","TCA","A","S",10,89985,5,83562,15,173547,1.36017648733291,4469
642,"TCG","CCG","S","P",1,88830,0,84178,1,173008,1.52406518644371,4470
642,"TCG","TAG","S",".",8,88830,10,84178,18,173008,0.871937365220542,4471
642,"TCG","TCA","S","S",22,88830,39,84178,61,173008,1.36667494352331,4472
642,"TCG","TCG","S","S",88779,88830,84116,84178,172895,173008,1,4473
642,"TCG","TCT","S","S",2,88830,3,84178,5,173008,0.984132642534276,4474
642,"TCG","TGG","S","W",1,88830,1,84178,2,173008,0.640649210048411,4475
642,"TCG","TTG","S","L",17,88830,9,84178,26,173008,1.36317630598588,4476
643,"TAC","AAC","Y","N",0,88146,1,83951,1,172097,1.59066415059622,4477
643,"TAC","CAC","Y","H",3,88146,4,83951,7,172097,0.904018469916604,4478
643,"TAC","TAA","Y",".",3,88146,5,83951,8,172097,1.14962437550719,4479
643,"TAC","TAC","Y","Y",88135,88146,83937,83951,172072,172097,1,4480
643,"TAC","TAG","Y",".",2,88146,0,83951,2,172097,2.21518035217504,4481
643,"TAC","TAT","Y","Y",2,88146,4,83951,6,172097,1.30421207498612,4482
643,"TAC","TTC","Y","F",1,88146,0,83951,1,172097,1.53213071929894,4483
644,"CCA","ACA","P","T",9,86574,8,84674,17,171248,0.779790482786913,4484
644,"CCA","CAA","P","Q",8,86574,6,84674,14,171248,0.948314581655022,4485
644,"CCA","CCA","P","P",86550,86574,84652,84674,171202,171248,1,4486
644,"CCA","CCG","P","P",1,86574,3,84674,4,171248,1.60072453265491,4487
644,"CCA","CCT","P","P",0,86574,1,84674,1,171248,1.60072453265491,4488
644,"CCA","CGA","P","R",1,86574,2,84674,3,171248,1.16521815839302,4489
644,"CCA","CTA","P","L",1,86574,0,84674,1,171248,1.57411937812572,4490
644,"CCA","TCA","P","S",4,86574,2,84674,6,171248,1.29672088542529,4491
645,"TGG","AGG","W","R",0,86451,1,86191,1,172642,1.60827253758258,4492
645,"TGG","CGG","W","R",1,86451,0,86191,1,172642,1.60476824221149,4493
645,"TGG","GGG","W","G",1,86451,0,86191,1,172642,1.60476824221149,4494
645,"TGG","TAG","W",".",2,86451,2,86191,4,172642,0.690231193032848,4495
645,"TGG","TCG","W","S",0,86451,1,86191,1,172642,1.60827253758258,4496
645,"TGG","TGA","W",".",9,86451,5,86191,14,172642,1.32484478255742,4497
645,"TGG","TGC","W","C",1,86451,0,86191,1,172642,1.60476824221149,4498
645,"TGG","TGG","W","W",86419,86451,86167,86191,172586,172642,1,4499
645,"TGG","TGT","W","C",10,86451,12,86191,22,172642,0.871657623671448,4500
645,"TGG","TTG","W","L",8,86451,3,86191,11,172642,1.79724748760743,4501
646,"CCT","ACT","P","T",8,85772,8,87515,16,173287,0.673303513074478,4502
646,"CCT","CAT","P","H",6,85772,11,87515,17,173287,1.34111207498908,4503
646,"CCT","CCA","P","P",1,85772,3,87515,4,173287,1.57749624121384,4504
646,"CCT","CCC","P","P",3,85772,8,87515,11,173287,1.76875747551455,4505
646,"CCT","CCT","P","P",85741,85772,87477,87515,173218,173287,1,4506
646,"CCT","CTT","P","L",0,85772,1,87515,1,173287,1.57749624121384,4507
646,"CCT","TCT","P","S",13,85772,7,87515,20,173287,1.39207856143724,4508
647,"ATA","AAA","I","K",1,83448,2,88035,3,171483,1.10553953299394,4509
647,"ATA","ATA","I","I",83427,83448,88030,88035,171457,171483,1,4510
647,"ATA","ATG","I","M",0,83448,2,88035,2,171483,2.20645028027302,4512
647,"ATA","ATT","I","I",1,83448,0,88035,1,171483,1.58885906903884,4513
647,"ATA","TTA","I","L",1,83448,0,88035,1,171483,1.58885906903884,4514
648,"GAT","AAT","D","N",0,85704,1,88654,1,174358,1.55576767548567,4515
648,"GAT","GAC","D","D",2,85704,1,88654,3,174358,1.1583520430749,4516
648,"GAT","GAT","D","D",85700,85704,88644,88654,174344,174358,1,4517
648,"GAT","GGT","D","G",0,85704,1,88654,1,174358,1.55576767548567,4518
648,"GAT","GTT","D","V",0,85704,1,88654,1,174358,1.55576767548567,4519
648,"GAT","TAT","D","Y",2,85704,6,88654,8,174358,1.80645386290042,4520
649,"GCA","ACA","A","T",19,84197,27,88470,46,172667,1.02078266187919,4521
649,"GCA","CCA","A","P",1,84197,0,88470,1,172667,1.5904179796845,4522
649,"GCA","GAA","A","E",9,84197,7,88470,16,172667,0.903529259228892,4523
649,"GCA","GCA","A","A",84159,84197,88427,88470,172586,172667,1,4524
649,"GCA","GTA","A","V",1,84197,2,88470,3,172667,1.11121513953228,4525
649,"GCA","TCA","A","S",8,84197,7,88470,15,172667,0.77538318466522,4526
650,"TCT","CCT","S","P",0,83075,1,89146,1,172221,1.49828237062704,4527
650,"TCT","TAT","S","Y",7,83075,10,89146,17,172221,0.971538768986022,4528
650,"TCT","TCA","S","S",1,83075,3,89146,4,172221,1.49828237062704,4529
650,"TCT","TCG","S","S",1,83075,0,89146,1,172221,1.58278576830223,4530
650,"TCT","TCT","S","S",83065,83075,89132,89146,172197,172221,1,4531
650,"TCT","TTT","S","F",1,83075,0,89146,1,172221,1.58278576830223,4532
651,"TTA","ATA","L","I",2,82459,0,89762,2,172221,2.28684698895429,4533
651,"TTA","CTA","L","L",2,82459,0,89762,2,172221,2.28684698895429,4534
651,"TTA","GTA","L","V",0,82459,2,89762,2,172221,2.15114088819378,4535
651,"TTA","TAA","L",".",0,82459,1,89762,1,172221,1.47599879238086,4536
651,"TTA","TCA","L","S",1,82459,2,89762,3,172221,1.06425014386939,4537
651,"TTA","TTA","L","L",82451,82459,89756,89762,172207,172221,1,4538
651,"TTA","TTG","L","L",1,82459,1,89762,2,172221,0.611856280099285,4539
651,"TTA","TTT","L","F",2,82459,0,89762,2,172221,2.28684698895429,4540
652,"CTC","ATC","L","I",0,81398,2,90726,2,172124,2.10954716984435,4541
652,"CTC","CAC","L","H",1,81398,1,90726,2,172124,0.590530248313494,4542
652,"CTC","CCC","L","P",0,81398,1,90726,1,172124,1.43978321282846,4543
652,"CTC","CGC","L","R",1,81398,0,90726,1,172124,1.56964564399416,4544
652,"CTC","CTA","L","L",9,81398,12,90726,21,172124,0.858813065264774,4545
652,"CTC","CTC","L","L",81373,81398,90698,90726,172071,172124,1,4546
652,"CTC","CTT","L","L",5,81398,4,90726,9,172124,0.808681124845476,4547
652,"CTC","GTC","L","V",2,81398,1,90726,3,172124,1.11676166475914,4548
652,"CTC","TTC","L","F",7,81398,7,90726,14,172124,0.590530248313494,4549
653,"GCT","ACT","A","T",42,79553,39,91590,81,171143,0.64703675421066,4550
653,"GCT","CCT","A","P",1,79553,0,91590,1,171143,1.55903853678888,4551
653,"GCT","GAT","A","D",5,79553,6,91590,11,171143,0.706367086391478,4552
653,"GCT","GCA","A","A",0,79553,2,91590,2,171143,2.05261389085236,4553
653,"GCT","GCC","A","A",6,79553,6,91590,12,171143,0.562040282148146,4554
653,"GCT","GCG","A","A",1,79553,0,91590,1,171143,1.55903853678888,4555
653,"GCT","GCT","A","A",79487,79553,91525,91590,171012,171143,1,4556
653,"GCT","GGT","A","G",0,79553,1,91590,1,171143,1.39053337621877,4557
653,"GCT","GTT","A","V",2,79553,0,91590,2,171143,2.27770288370565,4558
653,"GCT","TCT","A","S",9,79553,11,91590,20,171143,0.735304509317574,4559
654,"GAA","AAA","E","K",0,78857,5,92694,5,171551,3.29806693853332,4560
654,"GAA","GAA","E","E",78848,78857,92673,92694,171521,171551,1,4561
654,"GAA","GAG","E","E",1,78857,3,92694,4,171551,1.35984426409709,4562
654,"GAA","GAT","E","D",0,78857,2,92694,2,171551,2.01691030948036,4563
654,"GAA","GGA","E","G",1,78857,1,92694,2,171551,0.544587218567792,4564
654,"GAA","GTA","E","V",1,78857,0,92694,1,171551,1.55263401896047,4565
654,"GAA","TAA","E",".",6,78857,10,92694,16,171551,1.02517437621416,4566
655,"GCT","ACT","A","T",1,77437,2,93012,3,170449,0.939849897217315,4567
655,"GCT","CCT","A","P",1,77437,0,93012,1,170449,1.54610491614793,4568
655,"GCT","GAT","A","D",9,77437,15,93012,24,170449,1.0204615478465,4569
655,"GCT","GCA","A","A",0,77437,1,93012,1,170449,1.32776898368494,4570
655,"GCT","GCC","A","A",6,77437,6,93012,12,170449,0.526593242092183,4571
655,"GCT","GCG","A","A",0,77437,1,93012,1,170449,1.32776898368494,4572
655,"GCT","GCT","A","A",77402,77437,92969,93012,170371,170449,1,4573
655,"GCT","GGT","A","G",0,77437,1,93012,1,170449,1.32776898368494,4574
655,"GCT","GTT","A","V",11,77437,9,93012,20,170449,0.757601778766208,4575
655,"GCT","TCT","A","S",7,77437,8,93012,15,170449,0.629820414333865,4576
656,"GGT","AGT","G","S",4,76525,3,93239,7,169764,0.804731538224869,4577
656,"GGT","GAT","G","D",4,76525,5,93239,9,169764,0.678022578800577,4578
656,"GGT","GCT","G","A",1,76525,0,93239,1,169764,1.54192882072305,4579
656,"GGT","GGA","G","G",0,76525,1,93239,1,169764,1.3068139498881,4580
656,"GGT","GGC","G","G",1,76525,2,93239,3,169764,0.922507866092719,4581
656,"GGT","GGT","G","G",76509,76525,93221,93239,169730,169764,1,4582
656,"GGT","GTT","G","V",3,76525,3,93239,6,169764,0.514974671691193,4583
656,"GGT","TGT","G","C",3,76525,4,93239,7,169764,0.71905560246001,4584
657,"AAG","AAA","K","K",0,75389,1,94623,1,170012,1.26378052687776,4585
657,"AAG","AAG","K","K",75367,75389,94602,94623,169969,170012,1,4586
657,"AAG","AAT","K","N",7,75389,7,94623,14,170012,0.491455426423472,4587
657,"AAG","ACG","K","T",0,75389,1,94623,1,170012,1.26378052687776,4588
657,"AAG","AGG","K","R",10,75389,8,94623,18,170012,0.755427290727873,4589
657,"AAG","ATG","K","M",1,75389,2,94623,3,170012,0.887092892667205,4590
657,"AAG","GAG","K","E",3,75389,2,94623,5,170012,0.880651717298861,4591
657,"AAG","TAG","K",".",1,75389,0,94623,1,170012,1.53357010531101,4592
658,"GGT","AGT","G","S",4,76448,1,94632,5,171080,1.93187208186162,4593
658,"GGT","GAT","G","D",3,76448,3,94632,6,171080,0.502240909774676,4594
658,"GGT","GCT","G","A",1,76448,0,94632,1,171080,1.53738752487889,4595
658,"GGT","GGC","G","G",2,76448,0,94632,2,171080,2.26720866619813,4596
658,"GGT","GGT","G","G",76430,76448,94624,94632,171054,171080,1,4597
658,"GGT","GTT","G","V",4,76448,3,94632,7,171080,0.795216307621194,4598
658,"GGT","TGT","G","C",4,76448,1,94632,5,171080,1.93187208186162,4599
659,"TAC","CAC","Y","H",0,74838,3,95147,3,169985,2.38901246011795,4600
659,"TAC","GAC","Y","D",0,74838,2,95147,2,169985,1.88255659957497,4601
659,"TAC","TAA","Y",".",2,74838,2,95147,4,169985,0.481759327908948,4602
659,"TAC","TAC","Y","Y",74814,74838,95097,95147,169911,169985,1,4603
659,"TAC","TAT","Y","Y",20,74838,43,95147,63,169985,1.31293661543561,4604
659,"TAC","TGC","Y","C",1,74838,0,95147,1,169985,1.53016093524428,4605
659,"TAC","TTC","Y","F",1,74838,0,95147,1,169985,1.53016093524428,4606
660,"GGG","AGG","G","R",2,73953,1,96091,3,170044,1.04459326890488,4607
660,"GGG","GAG","G","E",2,73953,0,96091,2,170044,2.26095467389256,4608
660,"GGG","GCG","G","A",0,73953,1,96091,1,170044,1.21460677496869,4609
660,"GGG","GGA","G","G",22,73953,28,96091,50,170044,0.66348252495367,4610
660,"GGG","GGC","G","G",1,73953,1,96091,2,170044,0.465143249347788,4611
660,"GGG","GGG","G","G",73908,73953,96038,96091,169946,170044,1,4612
660,"GGG","GGT","G","G",4,73953,12,96091,16,170044,1.61014919522518,4613
660,"GGG","GTG","G","V",6,73953,5,96091,11,170044,0.669547573227027,4614
660,"GGG","TGG","G","W",8,73953,5,96091,13,170044,1.04459326890488,4615
661,"CTG","ATG","L","M",23,74557,38,97786,61,172343,0.930449973896786,4616
661,"CTG","CCG","L","P",0,74557,5,97786,5,172343,3.08811654262269,4617
661,"CTG","CGG","L","R",0,74557,1,97786,1,172343,1.20182797390505,4618
661,"CTG","CTA","L","L",2,74557,5,97786,7,172343,1.20182797390505,4619
661,"CTG","CTG","L","L",74515,74557,97713,97786,172228,172343,1,4620
661,"CTG","CTT","L","L",7,74557,14,97786,21,172343,1.1133380967862,4621
661,"CTG","GTG","L","V",1,74557,0,97786,1,172343,1.52203690829227,4622
661,"CTG","TTG","L","L",9,74557,10,97786,19,172343,0.532786477465173,4623
662,"ATC","AAC","I","N",0,72384,1,97615,1,169999,1.16299570189099,4624
662,"ATC","ACC","I","T",0,72384,5,97615,5,169999,3.03473821549563,4625
662,"ATC","ATA","I","I",8,72384,10,97615,18,169999,0.599616191070093,4626
662,"ATC","ATC","I","I",72367,72384,97591,97615,169958,169999,1,4627
662,"ATC","ATG","I","M",0,72384,1,97615,1,169999,1.16299570189099,4628
662,"ATC","ATT","I","I",7,72384,4,97615,11,169999,1.13458282934741,4629
662,"ATC","GTC","I","V",2,72384,2,97615,4,169999,0.438174878237433,4630
662,"ATC","TTC","I","F",0,72384,1,97615,1,169999,1.16299570189099,4631
663,"ATG","ACG","M","T",4,71196,2,98172,6,169368,1.19497823721788,4632
663,"ATG","ATA","M","I",7,71196,5,98172,12,169368,0.834423574129537,4633
663,"ATG","ATC","M","I",1,71196,0,98172,1,169368,1.5097740508536,4634
663,"ATG","ATG","M","M",71167,71196,98154,98172,169321,169368,1,4635
663,"ATG","ATT","M","I",5,71196,5,98172,10,169368,0.42245862943925,4636
663,"ATG","GTG","M","V",11,71196,6,98172,17,169368,1.2425635909736,4637
663,"ATG","TTG","M","L",1,71196,0,98172,1,169368,1.5097740508536,4638
664,"ACA","AAA","T","K",0,71220,6,97676,6,168896,3.29778569877924,4639
664,"ACA","ACA","T","T",71214,71220,97665,97676,168879,168896,1,4640
664,"ACA","ATA","T","I",1,71220,1,97676,2,168896,0.426369832827928,4641
664,"ACA","GCA","T","A",3,71220,4,97676,7,168896,0.604731811544996,4642
664,"ACA","TCA","T","S",2,71220,0,97676,2,168896,2.25462173647615,4643
665,"CCA","ACA","P","T",3,71460,4,97204,7,168664,0.612257509471725,4644
665,"CCA","CAA","P","Q",2,71460,1,97204,3,168664,1.02623446804063,4645
665,"CCA","CCA","P","P",71447,71460,97179,97204,168626,168664,1,4646
665,"CCA","CCG","P","P",4,71460,9,97204,13,168664,1.15125301764136,4647
665,"CCA","CCT","P","P",0,71460,3,97204,3,168664,2.26681393044534,4648
665,"CCA","CGA","P","R",0,71460,1,97204,1,168664,1.15125301764136,4649
665,"CCA","CTA","P","L",2,71460,5,97204,7,168664,1.15125301764136,4650
665,"CCA","TCA","P","S",2,71460,2,97204,4,168664,0.43213181340231,4651
666,"GCA","ACA","A","T",9,70472,14,95929,23,166401,0.794872653586159,4652
666,"GCA","CCA","A","P",0,70472,2,95929,2,166401,1.76757538663479,4653
666,"GCA","GAA","A","E",10,70472,10,95929,20,166401,0.431539678060651,4654
666,"GCA","GCA","A","A",70431,70472,95878,95929,166309,166401,1,4655
666,"GCA","GCG","A","A",0,70472,1,95929,1,166401,1.15009878688402,4656
666,"GCA","GCT","A","A",0,70472,2,95929,2,166401,1.76757538663479,4657
666,"GCA","GTA","A","V",12,70472,15,95929,27,166401,0.59741900182296,4658
666,"GCA","TCA","A","S",10,70472,7,95929,17,166401,0.887994638133696,4659
667,"GAT","AAT","D","N",0,70246,2,94705,2,164951,1.7837240808821,4660
667,"GAT","CAT","D","H",1,70246,0,94705,1,164951,1.51517560430913,4661
667,"GAT","GAC","D","D",1,70246,0,94705,1,164951,1.51517560430913,4662
667,"GAT","GAT","D","D",70240,70246,94693,94705,164933,164951,1,4663
667,"GAT","GGT","D","G",0,70246,1,94705,1,164951,1.16342589065328,4664
667,"GAT","GTT","D","V",0,70246,1,94705,1,164951,1.16342589065328,4665
667,"GAT","TAT","D","Y",4,70246,8,94705,12,164951,1.02342638978238,4666
668,"AAG","AAA","K","K",2,70191,0,94609,2,164800,2.25660110418307,4667
668,"AAG","AAG","K","K",70169,70191,94567,94609,164736,164800,1,4668
668,"AAG","AAT","K","N",5,70191,10,94609,15,164800,1.04750686105081,4669
668,"AAG","ACG","K","T",1,70191,2,94609,3,164800,0.805934740729123,4670
668,"AAG","AGG","K","R",10,70191,22,94609,32,164800,1.22584638226383,4671
668,"AAG","ATG","K","M",2,70191,6,94609,8,164800,1.38568457241851,4672
668,"AAG","GAG","K","E",2,70191,2,94609,4,164800,0.438624241247134,4673
669,"GGA","AGA","G","R",2,70037,3,92654,5,162691,0.701085147792439,4674
669,"GGA","GAA","G","E",0,70037,4,92654,4,162691,2.72697949123003,4675
669,"GGA","GGA","G","G",70026,70037,92633,92654,162659,162691,1,4676
669,"GGA","GGG","G","G",2,70037,3,92654,5,162691,0.701085147792439,4677
669,"GGA","GTA","G","V",4,70037,7,92654,11,162691,0.901360761460305,4678
669,"GGA","TGA","G",".",3,70037,4,92654,7,162691,0.638118093570686,4679
670,"GAG","AAG","E","K",1,69663,2,92950,3,162613,0.817257471861372,4680
670,"GAG","GAA","E","E",2,69663,1,92950,3,162613,1.03386143230179,4681
670,"GAG","GAC","E","D",0,69663,1,92950,1,162613,1.1779197976166,4682
670,"GAG","GAG","E","E",69652,69663,92919,92950,162571,162613,1,4683
670,"GAG","GAT","E","D",2,69663,3,92950,5,162613,0.692616257927415,4684
670,"GAG","GGG","E","G",2,69663,6,92950,8,162613,1.40099797176711,4685
670,"GAG","GTG","E","V",1,69663,1,92950,2,162613,0.445904866748597,4686
670,"GAG","TAG","E",".",3,69663,17,92950,20,162613,2.51596377307843,4687
671,"TGC","TAC","C","Y",7,69462,15,92970,22,162432,1.17365413921911,4688
671,"TGC","TGA","C",".",5,69462,8,92970,13,162432,0.813817435035956,4689
671,"TGC","TGC","C","C",69430,69462,92909,92970,162339,162432,1,4690
671,"TGC","TGT","C","C",13,69462,29,92970,42,162432,1.27096689639081,4691
671,"TGC","TTC","C","F",7,69462,9,92970,16,162432,0.627313609878981,4692
672,"TTT","CTT","F","L",0,71215,2,91808,2,163023,1.85876299862535,4693
672,"TTT","TCT","F","S",1,71215,0,91808,1,163023,1.52643776485741,4694
672,"TTT","TTA","F","L",0,71215,2,91808,2,163023,1.85876299862535,4695
672,"TTT","TTC","F","F",0,71215,1,91808,1,163023,1.22583807583617,4696
672,"TTT","TTT","F","F",71214,71215,91803,91808,163017,163023,1,4697
673,"AAC","AAA","N","K",2,70629,6,91614,8,162243,1.44371778756196,4698
673,"AAC","AAC","N","N",70622,70629,91598,91614,162220,162243,1,4699
673,"AAC","AAT","N","N",3,70629,4,91614,7,162243,0.656907670611887,4700
673,"AAC","AGC","N","S",0,70629,2,91614,2,162243,1.84845401100417,4701
673,"AAC","ATC","N","I",0,70629,2,91614,2,162243,1.84845401100417,4702
673,"AAC","GAC","N","D",1,70629,2,91614,3,162243,0.849081437574598,4703
673,"AAC","TAC","N","Y",1,70629,0,91614,1,162243,1.52484772098799,4704
674,"GAA","AAA","E","K",2,69868,4,90385,6,160253,0.978358994018111,4705
674,"GAA","GAA","E","E",69861,69868,90369,90385,160230,160253,1,4706
674,"GAA","GAG","E","E",1,69868,0,90385,1,160253,1.525541274804,4707
674,"GAA","GGA","E","G",0,69868,1,90385,1,160253,1.22098504564545,4708
674,"GAA","TAA","E",".",4,69868,11,90385,15,160253,1.4911851619695,4709
675,"GTT","ATT","V","I",3,69037,4,90002,7,159039,0.651937944735011,4710
675,"GTT","GCT","V","A",1,69037,1,90002,2,159039,0.462679529642551,4711
675,"GTT","GGT","V","G",1,69037,0,90002,1,159039,1.52351487026721,4712
675,"GTT","GTA","V","V",0,69037,1,90002,1,159039,1.20994404096162,4713
675,"GTT","GTG","V","V",0,69037,1,90002,1,159039,1.20994404096162,4714
675,"GTT","GTT","V","V",69028,69037,89995,90002,159023,159039,1,4715
675,"GTT","TTT","V","F",4,69037,0,90002,4,159039,3.24213616346343,4716
676,"ACC","AAC","T","N",1,68489,2,89946,3,158435,0.834980941713933,4717
676,"ACC","ACA","T","T",4,68489,9,89946,13,158435,1.19984168185786,4718
676,"ACC","ACC","T","T",68474,68489,89919,89946,158393,158435,1,4719
676,"ACC","ACT","T","T",8,68489,10,89946,18,158435,0.623940249923271,4720
676,"ACC","ATC","T","I",2,68489,4,89946,6,158435,0.95966714897071,4721
676,"ACC","CCC","T","P",0,68489,1,89946,1,158435,1.19984168185786,4722
676,"ACC","GCC","T","A",0,68489,1,89946,1,158435,1.19984168185786,4723
677,"TGG","AGG","W","R",1,68558,2,89932,3,158490,0.83634327864333,4724
677,"TGG","CGG","W","R",11,68558,14,89932,25,158490,0.646198286500715,4725
677,"TGG","GGG","W","G",1,68558,0,89932,1,158490,1.52198155268285,4726
677,"TGG","TAG","W",".",2,68558,2,89932,4,158490,0.458243677980032,4727
677,"TGG","TGA","W",".",0,68558,2,89932,2,158490,1.82964091166795,4728
677,"TGG","TGC","W","C",0,68558,2,89932,2,158490,1.82964091166795,4729
677,"TGG","TGG","W","W",68532,68558,89887,89932,158419,158490,1,4730
677,"TGG","TGT","W","C",9,68558,16,89932,25,158490,0.985794584217792,4731
677,"TGG","TTG","W","L",2,68558,7,89932,9,158490,1.63581656288951,4732
678,"ACC","AAC","T","N",5,68851,2,89397,7,158248,1.5245575489,4733
678,"ACC","ACA","T","T",2,68851,2,89397,4,158248,0.4656886409928,4734
678,"ACC","ACC","T","T",68840,68851,89387,89397,158227,158248,1,4735
678,"ACC","ACT","T","T",1,68851,1,89397,2,158248,0.4656886409928,4736
678,"ACC","ATC","T","I",0,68851,3,89397,3,158248,2.35040090483515,4737
678,"ACC","GCC","T","A",2,68851,2,89397,4,158248,0.4656886409928,4738
678,"ACC","TCC","T","S",1,68851,0,89397,1,158248,1.5245575489,4739
679,"AAC","AAA","N","K",1,68110,4,87308,5,155418,1.56942358144526,4740
679,"AAC","AAC","N","N",68103,68110,87296,87308,155399,155418,1,4741
679,"AAC","AAT","N","N",4,68110,5,87308,9,155418,0.629362280475678,4742
679,"AAC","ACC","N","T",0,68110,3,87308,3,155418,2.37378220068469,4743
679,"AAC","AGC","N","S",1,68110,0,87308,1,155418,1.52792857929032,4744
679,"AAC","GAC","N","D",1,68110,0,87308,1,155418,1.52792857929032,4745
680,"GCC","ACC","A","T",22,68036,37,85781,59,153817,0.999737343394256,4746
680,"GCC","GAC","A","D",4,68036,4,85781,8,153817,0.488101272470726,4747
680,"GCC","GCA","A","A",4,68036,5,85781,9,153817,0.645046974887077,4748
680,"GCC","GCC","A","A",67995,68036,85719,85781,153714,153817,1,4749
680,"GCC","GCT","A","A",3,68036,2,85781,5,153817,0.878380167738593,4750
680,"GCC","GTC","A","V",0,68036,1,85781,1,153817,1.25757404722963,4751
680,"GCC","TCC","A","S",8,68036,13,85781,21,153817,0.925272927692953,4752
681,"ACT","AAT","T","N",1,68349,2,86395,3,154744,0.878910203355022,4753
681,"ACT","ACA","T","T",1,68349,0,86395,1,154744,1.53167082625699,4754
681,"ACT","ACT","T","T",68347,68349,86391,86395,154738,154744,1,4755
681,"ACT","ATT","T","I",0,68349,2,86395,2,154744,1.89207151104783,4756
682,"TTC","ATC","F","I",2,67254,0,85258,2,152512,2.2640757374539,4757
682,"TTC","GTC","F","V",0,67254,1,85258,1,152512,1.24958882290199,4758
682,"TTC","TAC","F","Y",1,67254,0,85258,1,152512,1.53087662917595,4759
682,"TTC","TCC","F","S",2,67254,1,85258,3,152512,1.05508769605831,4760
682,"TTC","TTA","F","L",5,67254,10,85258,15,152512,1.12861570732951,4761
682,"TTC","TTC","F","F",67243,67254,85246,85258,152489,152512,1,4762
682,"TTC","TTT","F","F",1,67254,0,85258,1,152512,1.53087662917595,4763
683,"CTA","ATA","L","I",1,67641,3,84751,4,152392,1.2664281119744,4764
683,"CTA","CAA","L","Q",1,67641,2,84751,3,152392,0.889263940219355,4765
683,"CTA","CCA","L","P",3,67641,5,84751,8,152392,0.889263940219355,4766
683,"CTA","CTA","L","L",67634,67641,84739,84751,152373,152392,1,4767
683,"CTA","CTG","L","L",1,67641,0,84751,1,152392,1.53407603129942,4768
683,"CTA","GTA","L","V",0,67641,1,84751,1,152392,1.2664281119744,4769
683,"CTA","TTA","L","L",1,67641,1,84751,2,152392,0.492889165554993,4770
684,"AAG","AAA","K","K",1,67919,0,81799,1,149718,1.54535215516566,4771
684,"AAG","AAC","K","N",0,67919,1,81799,1,149718,1.32401761215697,4772
684,"AAG","AAG","K","K",67912,67919,81779,81799,149691,149718,1,4773
684,"AAG","AAT","K","N",5,67919,16,81799,21,149718,1.87734657497799,4774
684,"AAG","ACG","K","T",0,67919,1,81799,1,149718,1.32401761215697,4775
684,"AAG","AGG","K","R",1,67919,0,81799,1,149718,1.54535215516566,4776
684,"AAG","CAG","K","Q",0,67919,2,81799,2,149718,1.97499800831209,4777
685,"AGG","AAG","R","K",0,68246,1,81032,1,149278,1.34473943614137,4778
685,"AGG","AGG","R","R",68233,68246,81018,81032,149251,149278,1,4779
685,"AGG","AGT","R","S",4,68246,3,81032,7,149278,0.820570991812098,4780
685,"AGG","ATG","R","M",7,68246,8,81032,15,149278,0.640644505563558,4781
685,"AGG","GGG","R","G",1,68246,1,81032,2,149278,0.536081966921274,4782
685,"AGG","TGG","R","W",1,68246,1,81032,2,149278,0.536081966921274,4783
686,"TAT","CAT","Y","H",2,67359,0,80332,2,147691,2.27244027196826,4784
686,"TAT","TAA","Y",".",1,67359,0,80332,1,147691,1.54821124038671,4785
686,"TAT","TAC","Y","Y",0,67359,2,80332,2,147691,1.99162760444739,4786
686,"TAT","TAT","Y","Y",67355,67359,80330,80332,147685,147691,1,4787
686,"TAT","TGT","Y","C",1,67359,0,80332,1,147691,1.54821124038671,4788
687,"TTT","TTA","F","L",0,67852,1,79147,1,146999,1.3711841177391,4789
687,"TTT","TTC","F","F",1,67852,2,79147,3,146999,0.975976568856225,4790
687,"TTT","TTG","F","L",0,67852,1,79147,1,146999,1.3711841177391,4791
687,"TTT","TTT","F","F",67851,67852,79143,79147,146994,146999,1,4792
688,"AGA","AAA","R","K",1,68902,3,78213,4,147115,1.41213396887258,4793
688,"AGA","AGA","R","R",68893,68902,78198,78213,147091,147115,1,4794
688,"AGA","AGG","R","R",1,68902,3,78213,4,147115,1.41213396887258,4795
688,"AGA","ATA","R","I",3,68902,5,78213,8,147115,1.01028978897704,4796
688,"AGA","GGA","R","G",2,68902,3,78213,5,147115,0.867045468088159,4797
688,"AGA","TGA","R",".",2,68902,1,78213,3,147115,1.10729989011996,4798
689,"GCA","ACA","A","T",3,68315,3,76702,6,145017,0.583945757196776,4799
689,"GCA","GAA","A","E",4,68315,1,76702,5,145017,1.95204836112149,4800
689,"GCA","GCA","A","A",68273,68315,76663,76702,144936,145017,1,4801
689,"GCA","GGA","A","G",0,68315,1,76702,1,145017,1.42849105171638,4802
689,"GCA","GTA","A","V",22,68315,27,76702,49,145017,0.77721560328111,4803
689,"GCA","TCA","A","S",13,68315,7,76702,20,145017,1.34952654004587,4804
690,"GAT","AAT","D","N",2,67240,1,77420,3,144660,1.10003764678399,4805
690,"GAT","GAC","D","D",1,67240,1,77420,2,144660,0.56205801655996,4806
690,"GAT","GAT","D","D",67229,67240,77409,77420,144638,144660,1,4807
690,"GAT","GGT","D","G",3,67240,3,77420,6,144660,0.56205801655996,4808
690,"GAT","TAT","D","Y",5,67240,6,77420,11,144660,0.706387980764679,4809
691,"GAA","AAA","E","K",0,65572,3,76193,3,141765,2.5531293137845,4810
691,"GAA","GAA","E","E",65555,65572,76183,76193,141738,141765,1,4811
691,"GAA","GAC","E","D",1,65572,0,76193,1,141765,1.55613264804933,4812
691,"GAA","GAG","E","E",2,65572,0,76193,2,141765,2.27628760015974,4813
691,"GAA","GGA","E","G",1,65572,0,76193,1,141765,1.55613264804933,4814
691,"GAA","TAA","E",".",13,65572,7,76193,20,141765,1.33577780449976,4815
692,"CAG","AAG","Q","K",5,66337,3,75209,8,141546,1.10785541726516,4816
692,"CAG","CAA","Q","Q",8,66337,7,75209,15,141546,0.714655672966986,4817
692,"CAG","CAG","Q","Q",66312,66337,75187,75209,141499,141546,1,4818
692,"CAG","CAT","Q","H",2,66337,2,75209,4,141546,0.575409232150207,4819
692,"CAG","CCG","Q","P",1,66337,0,75209,1,141546,1.56399231524474,4820
692,"CAG","CGG","Q","R",1,66337,4,75209,5,141546,1.76842466674741,4821
692,"CAG","CTG","Q","L",2,66337,0,75209,2,141546,2.2801204349744,4822
692,"CAG","TAG","Q",".",6,66337,6,75209,12,141546,0.575409232150207,4823
693,"TAC","AAC","Y","N",0,66365,1,73167,1,139532,1.45645836171162,4824
693,"TAC","CAC","Y","H",0,66365,1,73167,1,139532,1.45645836171162,4825
693,"TAC","TAA","Y",".",2,66365,4,73167,6,139532,1.18943775346306,4826
693,"TAC","TAC","Y","Y",66352,66365,73154,73167,139506,139532,1,4827
693,"TAC","TAT","Y","Y",8,66365,5,73167,13,139532,1.12255147527824,4828
693,"TAC","TCC","Y","S",1,66365,0,73167,1,139532,1.57333063772955,4829
693,"TAC","TGC","Y","C",2,66365,2,73167,4,139532,0.600310188114941,4830
694,"CCC","ACC","P","T",4,66120,6,72484,10,138604,0.967314098420815,4831
694,"CCC","CAC","P","H",3,66120,3,72484,6,138604,0.605449679597169,4832
694,"CCC","CCA","P","P",8,66120,6,72484,14,138604,0.910327827165374,4833
694,"CCC","CCC","P","P",66103,66120,72467,72484,138570,138604,1,4834
694,"CCC","CCT","P","P",0,66120,1,72484,1,138604,1.46517565999108,4835
694,"CCC","TCC","P","S",2,66120,1,72484,3,138604,1.12560335399255,4836
695,"TTC","ATC","F","I",1,65428,1,73282,2,138710,0.586120921922938,4837
695,"TTC","CTC","F","L",1,65428,1,73282,2,138710,0.586120921922938,4838
695,"TTC","GTA","F","V",1,65428,0,73282,1,138710,1.5679915894116,4839
695,"TTC","GTC","F","V",0,65428,1,73282,1,138710,1.43222726480668,4840
695,"TTC","TAC","F","Y",1,65428,0,73282,1,138710,1.5679915894116,4841
695,"TTC","TTA","F","L",6,65428,2,73282,8,138710,1.83121230334393,4842
695,"TTC","TTC","F","F",65418,65428,73277,73282,138695,138710,1,4843
696,"CTG","ATG","L","M",5,65437,3,72037,8,137474,1.12332912505188,4844
696,"CTG","CCG","L","P",1,65437,5,72037,6,137474,2.13128304596314,4845
696,"CTG","CTA","L","L",3,65437,3,72037,6,137474,0.601620802128583,4846
696,"CTG","CTG","L","L",65421,65437,72023,72037,137444,137474,1,4847
696,"CTG","CTT","L","L",4,65437,3,72037,7,137474,0.870277992495229,4848
696,"CTG","TTG","L","L",3,65437,0,72037,3,137474,2.8228703028058,4849
697,"GTG","ATG","V","M",1,65249,3,71033,4,136282,1.47593287868723,4850
697,"GTG","GAG","V","E",0,65249,1,71033,1,136282,1.47593287868723,4851
697,"GTG","GCG","V","A",0,65249,2,71033,2,136282,2.15106538770519,4852
697,"GTG","GTA","V","V",35,65249,38,71033,73,136282,0.688269408890978,4853
697,"GTG","GTG","V","V",65204,65249,70984,71033,136188,136282,1,4854
697,"GTG","GTT","V","V",8,65249,3,71033,11,136282,1.77601599358598,4855
697,"GTG","TTG","V","L",1,65249,2,71033,3,136282,1.06419417891148,4856
698,"CAT","AAT","H","N",5,65957,3,71571,8,137528,1.13118356305209,4857
698,"CAT","CAC","H","H",5,65957,6,71571,11,137528,0.768265038989017,4858
698,"CAT","CAT","H","H",65945,65957,71556,71571,137501,137528,1,4859
698,"CAT","TAT","H","Y",2,65957,6,71571,8,137528,1.72705908056064,4860
699,"CCT","ACT","P","T",3,66134,6,72134,9,138268,1.27362174466575,4861
699,"CCT","CAT","P","H",3,66134,2,72134,5,138268,0.962484488084086,4862
699,"CCT","CCA","P","P",1,66134,0,72134,1,138268,1.57700056243186,4863
699,"CCT","CCC","P","P",12,66134,8,72134,20,138268,1.07392171803652,4864
699,"CCT","CCT","P","P",66108,66134,72112,72134,138220,138268,1,4865
699,"CCT","CGT","P","R",0,66134,1,72134,1,138268,1.47285316975324,4866
699,"CCT","CTT","P","L",5,66134,4,72134,9,138268,0.824357659555603,4867
699,"CCT","TCT","P","S",2,66134,1,72134,3,138268,1.12830554519619,4868
700,"GTT","ATT","V","I",5,66325,5,72054,10,138379,0.613670497985496,4869
700,"GTT","GCT","V","A",1,66325,2,72054,3,138379,1.06684569791521,4870
700,"GTT","GTA","V","V",0,66325,2,72054,2,138379,2.15464084694725,4871
700,"GTT","GTC","V","V",5,66325,2,72054,7,138379,1.57840103531862,4872
700,"GTT","GTT","V","V",66308,66325,72040,72054,138348,138379,1,4873
700,"GTT","TTT","V","F",6,66325,3,72054,9,138379,1.36346041742054,4874
701,"ATG","AAG","M","K",1,65490,0,72510,1,138000,1.57189916992048,4875
701,"ATG","ATA","M","I",1,65490,4,72510,5,138000,1.80806898202142,4876
701,"ATG","ATG","M","M",65478,65490,72495,72510,137973,138000,1,4877
701,"ATG","ATT","M","I",9,65490,9,72510,18,138000,0.596518161614265,4878
701,"ATG","GTG","M","V",1,65490,2,72510,3,138000,1.04222442354284,4879
702,"CCC","ACC","P","T",6,66105,7,72442,13,138547,0.735950411476768,4880
702,"CCC","CAC","P","H",3,66105,4,72442,7,138547,0.833310123482075,4881
702,"CCC","CCA","P","P",3,66105,4,72442,7,138547,0.833310123482075,4882
702,"CCC","CCC","P","P",66055,66105,72392,72442,138447,138547,1,4883
702,"CCC","CCG","P","P",1,66105,0,72442,1,138547,1.57538263677194,4884
702,"CCC","CCT","P","P",6,66105,3,72442,9,138547,1.35971688602925,4885
702,"CCC","CTC","P","L",2,66105,2,72442,4,138547,0.605730480258367,4886
702,"CCC","TCC","P","S",29,66105,30,72442,59,138547,0.636058979499233,4887
703,"ATG","AAG","M","K",1,65750,0,73096,1,138846,1.57050816822528,4888
703,"ATG","ACG","M","T",5,65750,4,73096,9,138846,0.810526312607028,4889
703,"ATG","AGG","M","R",1,65750,0,73096,1,138846,1.57050816822528,4890
703,"ATG","ATA","M","I",0,65750,2,73096,2,138846,2.11406306536522,4891
703,"ATG","ATG","M","M",65735,65750,73080,73096,138815,138846,1,4892
703,"ATG","ATT","M","I",7,65750,9,73096,16,138846,0.817223842227966,4893
703,"ATG","GTG","M","V",1,65750,1,73096,2,138846,0.592824730501503,4894
704,"AAA","AAA","K","K",65620,65629,72921,72930,138541,138559,1,4895
704,"AAA","AAG","K","K",1,65629,0,72930,1,138559,1.57065192637566,4896
704,"AAA","AAT","K","N",0,65629,2,72930,2,138559,2.11481413500596,4897
704,"AAA","AGA","K","R",5,65629,2,72930,7,138559,1.57065192637566,4898
704,"AAA","ATA","K","I",2,65629,1,72930,3,138559,1.1183439317996,4899
704,"AAA","GAA","K","E",1,65629,4,72930,5,138559,1.80189830971024,4900
705,"GAC","AAC","D","N",0,65690,2,74330,2,140020,2.08331574612,4901
705,"GAC","CAC","D","H",1,65690,0,74330,1,140020,1.56469745796577,4902
705,"GAC","GAA","D","E",1,65690,1,74330,2,140020,0.577303123304974,4903
705,"GAC","GAC","D","D",65683,65690,74313,74330,139996,140020,1,4904
705,"GAC","GAT","D","D",0,65690,3,74330,3,140020,2.60266384161671,4905
705,"GAC","GGC","D","G",1,65690,5,74330,6,140020,2.08331574612,4906
705,"GAC","TAC","D","Y",4,65690,6,74330,10,140020,0.928696367314272,4907
706,"ATA","ACA","I","T",1,66151,3,74345,4,140496,1.42716367945875,4908
706,"ATA","ATA","I","I",66142,66151,74335,74345,140477,140496,1,4909
706,"ATA","ATG","I","M",6,66151,6,74345,12,140496,0.583173799466168,4910
706,"ATA","ATT","I","I",1,66151,0,74345,1,140496,1.56688858599247,4911
706,"ATA","GTA","I","V",1,66151,1,74345,2,140496,0.583173799466168,4912
707,"CAC","AAC","H","N",1,66684,1,73661,2,140345,0.598510872719996,4913
707,"CAC","CAA","H","Q",3,66684,5,73661,8,140345,1.0450943352135,4914
707,"CAC","CAC","H","H",66666,66684,73647,73661,140313,140345,1,4915
707,"CAC","CAG","H","Q",1,66684,0,73661,1,140345,1.57265098541186,4916
707,"CAC","CAT","H","H",6,66684,4,73661,10,140345,1.02223775852651,4917
707,"CAC","CCC","H","P",0,66684,1,73661,1,140345,1.45339907381575,4918
707,"CAC","CGC","H","R",2,66684,1,73661,3,140345,1.12148453086866,4919
707,"CAC","TAC","H","Y",5,66684,2,73661,7,140345,1.57265098541186,4920
708,"GAA","AAA","E","K",3,68293,9,73541,12,141834,1.85479610596529,4921
708,"GAA","GAA","E","E",68279,68293,73522,73541,141801,141834,1,4922
708,"GAA","GAC","E","D",1,68293,0,73541,1,141834,1.58154514587069,4923
708,"GAA","GAG","E","E",1,68293,0,73541,1,141834,1.58154514587069,4924
708,"GAA","GTA","E","V",2,68293,0,73541,2,141834,2.28873595736325,4925
708,"GAA","TAA","E",".",7,68293,10,73541,17,141834,0.96720987926736,4926
709,"TCA","CCA","S","P",1,68195,0,72673,1,140868,1.58525138820358,4927
709,"TCA","GCA","S","A",0,68195,1,72673,1,140868,1.50897040999076,4928
709,"TCA","TAA","S",".",6,68195,9,72673,15,140868,1.0285387525667,4929
709,"TCA","TCA","S","S",68183,68195,72662,72673,140845,140868,1,4930
709,"TCA","TCG","S","S",1,68195,0,72673,1,140868,1.58525138820358,4931
709,"TCA","TTA","S","L",4,68195,1,72673,5,140868,1.96438390064934,4932
710,"ATT","AAT","I","N",0,69202,1,72408,1,141610,1.53762216400006,4933
710,"ATT","AGT","I","S",1,69202,0,72408,1,141610,1.59196167964497,4934
710,"ATT","ATA","I","I",1,69202,0,72408,1,141610,1.59196167964497,4935
710,"ATT","ATC","I","I",1,69202,0,72408,1,141610,1.59196167964497,4936
710,"ATT","ATT","I","I",69198,69202,72405,72408,141603,141610,1,4937
710,"ATT","GTT","I","V",1,69202,2,72408,3,141610,1.11681245526262,4938
711,"AGA","AAA","R","K",1,69974,0,72273,1,142247,1.59676549880329,4939
711,"AGA","ACA","R","T",1,69974,0,72273,1,142247,1.59676549880329,4940
711,"AGA","AGA","R","R",69953,69974,72265,72273,142218,142247,1,4941
711,"AGA","AGG","R","R",5,69974,1,72273,6,142247,2.29626895980272,4942
711,"AGA","ATA","R","I",7,69974,5,72273,12,142247,0.998723993163017,4943
711,"AGA","GGA","R","G",7,69974,2,72273,9,142247,2.08544210568116,4944
712,"TGG","CGG","W","R",0,71198,2,72111,2,143309,2.27989628386374,4945
712,"TGG","TAG","W",".",1,71198,4,72111,5,143309,1.95927935607702,4946
712,"TGG","TCG","W","S",1,71198,0,72111,1,143309,1.60444025520316,4947
712,"TGG","TGA","W",".",1,71198,0,72111,1,143309,1.60444025520316,4948
712,"TGG","TGC","W","C",1,71198,3,72111,4,143309,1.58929565341142,4949
712,"TGG","TGG","W","W",71175,71198,72079,72111,143254,143309,1,4950
712,"TGG","TGT","W","C",15,71198,18,72111,33,143309,0.865000287079824,4951
712,"TGG","TTG","W","L",4,71198,5,72111,9,143309,0.877178372600614,4952
713,"ACC","AAC","T","N",2,72327,1,71034,3,143361,1.15398673091612,4953
713,"ACC","ACA","T","T",5,72327,2,71034,7,143361,1.58087707385027,4954
713,"ACC","ACC","T","T",72314,72327,71030,71034,143344,143361,1,4955
713,"ACC","ACT","T","T",2,72327,0,71034,2,143361,2.2703961043556,4956
713,"ACC","ATC","T","I",1,72327,0,71034,1,143361,1.58087707385027,4957
713,"ACC","GCC","T","A",2,72327,1,71034,3,143361,1.15398673091612,4958
713,"ACC","TCC","T","S",1,72327,0,71034,1,143361,1.58087707385027,4959
714,"AAG","AAA","K","K",2,73113,4,71341,6,144454,1.31631198370392,4960
714,"AAG","AAG","K","K",73095,73113,71314,71341,144409,144454,1,4961
714,"AAG","AAT","K","N",11,73113,13,71341,24,144454,0.838534288630909,4962
714,"AAG","ACG","K","T",1,73113,0,71341,1,144454,1.57016740305385,4963
714,"AAG","AGG","K","R",2,73113,4,71341,6,144454,1.31631198370392,4964
714,"AAG","ATG","K","M",1,73113,4,71341,5,144454,1.97433977409646,4965
714,"AAG","GAG","K","E",1,73113,1,71341,2,144454,0.668784417492424,4966
714,"AAG","TAG","K",".",0,73113,1,71341,1,144454,1.59976391528739,4967
715,"GAT","AAT","D","N",2,76562,2,71737,4,148299,0.630073103914661,4968
715,"GAT","CAT","D","H",1,76562,0,71737,1,148299,1.50651694750904,4969
715,"GAT","GAA","D","E",0,76562,1,71737,1,148299,1.58468360615857,4970
715,"GAT","GAC","D","D",1,76562,1,71737,2,148299,0.630073103914661,4971
715,"GAT","GAT","D","D",76554,76562,71722,71737,148276,148299,1,4972
715,"GAT","GGT","D","G",0,76562,1,71737,1,148299,1.58468360615857,4973
715,"GAT","TAT","D","Y",4,76562,10,71737,14,148299,1.74357499446066,4974
716,"CCA","ACA","P","T",8,78510,7,72183,15,150693,0.727475595183368,4975
716,"CCA","CAA","P","Q",4,78510,3,72183,7,150693,0.841912416885163,4976
716,"CCA","CCA","P","P",78494,78510,72168,72183,150662,150693,1,4977
716,"CCA","CCG","P","P",0,78510,2,72183,2,150693,2.28699547266228,4978
716,"CCA","CCT","P","P",0,78510,1,72183,1,150693,1.57801178150355,4979
716,"CCA","CGA","P","R",2,78510,0,72183,2,150693,2.15267041746387,4980
716,"CCA","CTA","P","L",0,78510,1,72183,1,150693,1.57801178150355,4981
716,"CCA","TCA","P","S",2,78510,1,72183,3,150693,1.0653841472784,4982
717,"AAG","AAA","K","K",2,80367,1,71150,3,151517,1.0164732260928,4983
717,"AAG","AAG","K","K",80353,80367,71136,71150,151489,151517,1,4984
717,"AAG","AAT","K","N",4,80367,11,71150,15,151517,1.87850999216144,4985
717,"AAG","ACG","K","T",0,80367,1,71150,1,151517,1.56522420583899,4986
717,"AAG","AGG","K","R",4,80367,1,71150,5,151517,1.77468468771939,4987
717,"AAG","ATG","K","M",1,80367,0,71150,1,151517,1.41948477443054,4988
717,"AAG","GAG","K","E",2,80367,0,71150,2,151517,2.08613487101882,4989
717,"AAG","TAG","K",".",1,80367,0,71150,1,151517,1.41948477443054,4990
718,"AAC","AAA","N","K",4,87360,4,70871,8,158231,0.505707319604706,4991
718,"AAC","AAC","N","N",87351,87360,70865,70871,158216,158231,1,4992
718,"AAC","AAT","N","N",4,87360,1,70871,5,158231,1.63188159979129,4993
718,"AAC","AGC","N","S",1,87360,1,70871,2,158231,0.505707319604706,4994
719,"ACC","AAC","T","N",7,89618,0,69794,7,159412,3.68464125583449,4995
719,"ACC","ACA","T","T",7,89618,3,69794,10,159412,1.23166391950226,4996
719,"ACC","ACC","T","T",89595,89618,69788,69794,159383,159412,1,4997
719,"ACC","ACT","T","T",5,89618,0,69794,5,159412,3.12861593336873,4998
719,"ACC","AGC","T","S",1,89618,0,69794,1,159412,1.23166391950226,4999
719,"ACC","ATC","T","I",3,89618,3,69794,6,159412,0.474202135284104,5000
720,"CAA","AAA","Q","K",6,94411,4,68265,10,162676,0.70546916655744,5001
720,"CAA","CAA","Q","Q",94397,94411,68257,68265,162654,162676,1,5002
720,"CAA","CAC","Q","H",1,94411,2,68265,3,162676,1.01987759104158,5003
720,"CAA","CAG","Q","Q",1,94411,1,68265,2,162676,0.420587073246709,5004
720,"CAA","CAT","Q","H",1,94411,0,68265,1,162676,1.12863094743467,5005
720,"CAA","CGA","Q","R",3,94411,0,68265,3,162676,2.23705249218663,5006
720,"CAA","GAA","Q","E",1,94411,0,68265,1,162676,1.12863094743467,5007
720,"CAA","TAA","Q",".",1,94411,1,68265,2,162676,0.420587073246709,5008
721,"GAT","AAT","D","N",2,101533,1,68704,3,170237,0.708158443370059,5009
721,"GAT","GAC","D","D",0,101533,1,68704,1,170237,1.49467521051534,5010
721,"GAT","GAT","D","D",101519,101533,68695,68704,170214,170237,1,5011
721,"GAT","GGT","D","G",1,101533,0,68704,1,170237,1.04082559619209,5012
721,"GAT","GTT","D","V",1,101533,0,68704,1,170237,1.04082559619209,5013
721,"GAT","TAT","D","Y",10,101533,7,68704,17,170237,0.623633818153006,5014
722,"CAC","AAC","H","N",7,105194,10,68283,17,173477,0.838110297930941,5015
722,"CAC","CAA","H","Q",8,105194,3,68283,11,173477,1.14204842714804,5016
722,"CAC","CAC","H","H",105146,105194,68253,68283,173399,173477,1,5017
722,"CAC","CAT","H","H",24,105194,12,68283,36,173477,0.939349547782177,5018
722,"CAC","CGC","H","R",5,105194,2,68283,7,173477,0.987857794669364,5019
722,"CAC","GAC","H","D",0,105194,1,68283,1,173477,1.48644934645779,5020
722,"CAC","TAC","H","Y",4,105194,2,68283,6,173477,0.774943307212796,5021
723,"GTG","ATG","V","M",10,109860,9,67736,19,177596,0.378416908214228,5022
723,"GTG","CTG","V","L",2,109860,0,67736,2,177596,1.48642823960262,5023
723,"GTG","GCG","V","A",1,109860,1,67736,2,177596,0.322186194889607,5024
723,"GTG","GTA","V","V",3,109860,3,67736,6,177596,0.322186194889607,5025
723,"GTG","GTG","V","V",109830,109860,67716,67736,177546,177596,1,5026
723,"GTG","GTT","V","V",9,109860,6,67736,15,177596,0.574250712301149,5027
723,"GTG","TTG","V","L",5,109860,1,67736,6,177596,1.48642823960262,5028
724,"CGC","AGC","R","S",6,118672,4,67287,10,185959,0.488597973014707,5029
724,"CGC","CAC","R","H",42,118672,33,67287,75,185959,0.414849450903313,5030
724,"CGC","CCC","R","P",1,118672,2,67287,3,185959,0.944467416784774,5031
724,"CGC","CGA","R","R",10,118672,4,67287,14,185959,0.938360031438401,5032
724,"CGC","CGC","R","R",118570,118672,67224,67287,185794,185959,1,5033
724,"CGC","CGG","R","R",1,118672,0,67287,1,185959,0.826704708666483,5034
724,"CGC","CGT","R","R",2,118672,2,67287,4,185959,0.278724704382905,5035
724,"CGC","CTC","R","L",7,118672,5,67287,12,185959,0.452002019486255,5036
724,"CGC","TGC","R","C",33,118672,13,67287,46,185959,1.06328236540193,5037
725,"TCA","ACA","S","T",1,122405,0,65776,1,188181,0.767847210701509,5038
725,"TCA","CCA","S","P",6,122405,2,65776,8,188181,0.944780623537302,5039
725,"TCA","TAA","S",".",13,122405,7,65776,20,188181,0.633604201967987,5040
725,"TCA","TCA","S","S",122381,122405,65765,65776,188146,188181,1,5041
725,"TCA","TCG","S","S",1,122405,2,65776,3,188181,0.931683821357825,5042
725,"TCA","TCT","S","S",2,122405,0,65776,2,188181,1.28066266974837,5043
725,"TCA","TTA","S","L",1,122405,0,65776,1,188181,0.767847210701509,5044
726,"CTG","ATG","L","M",3,127122,2,63615,5,190737,0.368233359143073,5045
726,"CTG","CAG","L","Q",6,127122,2,63615,8,190737,0.860084944227453,5046
726,"CTG","CCG","L","P",20,127122,13,63615,33,190737,0.446882114362034,5047
726,"CTG","CGG","L","R",9,127122,1,63615,10,190737,1.98242571465504,5048
726,"CTG","CTA","L","L",7,127122,2,63615,9,190737,1.02270880152584,5049
726,"CTG","CTC","L","L",1,127122,0,63615,1,190737,0.693973490166847,5050
726,"CTG","CTG","L","L",127070,127122,63587,63615,190657,190737,1,5051
726,"CTG","CTT","L","L",2,127122,7,63615,9,190737,1.99626703583945,5052
726,"CTG","TTG","L","L",4,127122,1,63615,5,190737,0.941990947752935,5053
727,"TGT","CGT","C","R",1,130794,0,62432,1,193226,0.647760906854799,5054
727,"TGT","GGT","C","G",1,130794,0,62432,1,193226,0.647760906854799,5055
727,"TGT","TAT","C","Y",3,130794,1,62432,4,193226,0.647760906854799,5056
727,"TGT","TCT","C","S",0,130794,1,62432,1,193226,1.44168510730373,5057
727,"TGT","TGC","C","C",2,130794,3,62432,5,193226,0.695939237142563,5058
727,"TGT","TGT","C","C",130785,130794,62423,62432,193208,193226,1,5059
727,"TGT","TTT","C","F",2,130794,4,62432,6,193226,1.10047452562984,5060
728,"CTA","ATA","L","I",13,136598,3,60633,16,197231,1.22777793362274,5061
728,"CTA","CAA","L","Q",0,136598,1,60633,1,197231,1.43437748778226,5062
728,"CTA","CCA","L","P",2,136598,5,60633,7,197231,1.43437748778226,5063
728,"CTA","CGA","L","R",1,136598,0,60633,1,197231,0.581168126209823,5064
728,"CTA","CTA","L","L",136578,136598,60624,60633,197202,197231,1,5065
728,"CTA","CTG","L","L",1,136598,0,60633,1,197231,0.581168126209823,5066
728,"CTA","GTA","L","V",2,136598,0,60633,2,197231,1.02003197134749,5067
728,"CTA","TTA","L","L",1,136598,0,60633,1,197231,0.581168126209823,5068
729,"TTA","CTA","L","L",0,146925,1,59077,1,206002,1.42591553807219,5069
729,"TTA","GTA","L","V",1,146925,1,59077,2,206002,0.149855408072858,5070
729,"TTA","TAA","L",".",0,146925,1,59077,1,206002,1.42591553807219,5071
729,"TTA","TGA","L",".",1,146925,0,59077,1,206002,0.498752062014613,5072
729,"TTA","TTA","L","L",146911,146925,59069,59077,205980,206002,1,5073
729,"TTA","TTC","L","F",1,146925,0,59077,1,206002,0.498752062014613,5074
729,"TTA","TTG","L","L",9,146925,5,59077,14,206002,0.370924009093366,5075
729,"TTA","TTT","L","F",2,146925,0,59077,2,206002,0.898125281484042,5076
730,"GCT","ACT","A","T",6,154050,4,57417,10,211467,0.240795571371525,5077
730,"GCT","CCT","A","P",1,154050,0,57417,1,211467,0.441883523511763,5078
730,"GCT","GAT","A","D",16,154050,7,57417,23,211467,0.486897188196868,5079
730,"GCT","GCC","A","A",1,154050,0,57417,1,211467,0.441883523511763,5080
730,"GCT","GCG","A","A",1,154050,0,57417,1,211467,0.441883523511763,5081
730,"GCT","GCT","A","A",153995,154050,57394,57417,211389,211467,1,5082
730,"GCT","GTT","A","V",5,154050,2,57417,7,211467,0.441883523511763,5083
730,"GCT","TCT","A","S",25,154050,10,57417,35,211467,0.574392664794593,5084
731,"TGG","AGG","W","R",2,157053,0,56034,2,213087,0.763622090000379,5085
731,"TGG","CCT","W","P",1,157053,0,56034,1,213087,0.411678444687477,5086
731,"TGG","CGG","W","R",2,157053,0,56034,2,213087,0.763622090000379,5087
731,"TGG","GGG","W","G",1,157053,0,56034,1,213087,0.411678444687477,5088
731,"TGG","TAG","W",".",5,157053,0,56034,5,213087,1.71993064663016,5089
731,"TGG","TGA","W",".",38,157053,9,56034,47,213087,1.07732043235523,5090
731,"TGG","TGC","W","C",1,157053,0,56034,1,213087,0.411678444687477,5091
731,"TGG","TGG","W","W",156981,157053,56017,56034,212998,213087,1,5092
731,"TGG","TGT","W","C",12,157053,5,56034,17,213087,0.468613706401137,5093
731,"TGG","TTG","W","L",10,157053,3,56034,13,213087,0.674467796693318,5094
732,"CAT","AAA","H","K",0,163768,1,52673,1,216441,1.41182740354561,5095
732,"CAT","AAT","H","N",15,163768,7,52673,22,216441,0.346273223059677,5096
732,"CAT","CAC","H","H",1,163768,0,52673,1,216441,0.346273223059677,5097
732,"CAT","CAT","H","H",163714,163768,52655,52673,216369,216441,1,5098
732,"CAT","CGT","H","R",1,163768,0,52673,1,216441,0.346273223059677,5099
732,"CAT","CTT","H","L",1,163768,2,52673,3,216441,0.855881151478499,5100
732,"CAT","TAT","H","Y",36,163768,8,52673,44,216441,1.01101367503073,5101
733,"AAC","AAA","N","K",10,170183,1,50772,11,220955,1.30636681496164,5102
733,"AAC","AAC","N","N",170135,170183,50760,50772,220895,220955,1,5103
733,"AAC","AAT","N","N",25,170183,7,50772,32,220955,0.662807103027945,5104
733,"AAC","AGC","N","S",7,170183,0,50772,7,220955,1.90166291012383,5105
733,"AAC","CAC","N","H",0,170183,1,50772,1,220955,1.40830434564974,5106
733,"AAC","GAC","N","D",6,170183,3,50772,9,220955,0.241071003156252,5107
734,"GGG","AGG","G","R",7,175375,2,50298,9,225673,0.46057621699998,5108
734,"GGG","CGG","G","R",1,175375,0,50298,1,225673,0.284468312231654,5109
734,"GGG","GAG","G","E",4,175375,1,50298,5,225673,0.4148533976293,5110
734,"GGG","GCG","G","A",3,175375,0,50298,3,225673,0.83993688822292,5111
734,"GGG","GGA","G","G",5,175375,0,50298,5,225673,1.37662192873956,5112
734,"GGG","GGC","G","G",3,175375,1,50298,4,225673,0.284468312231654,5113
734,"GGG","GGG","G","G",175334,175375,50288,50298,225622,225673,1,5114
734,"GGG","GGT","G","G",4,175375,0,50298,4,225673,1.11730154688801,5115
734,"GGG","GTG","G","V",2,175375,4,50298,6,225673,1.05083616222177,5116
734,"GGG","TGG","G","W",12,175375,2,50298,14,225673,0.934025082706708,5117
735,"GAG","AAG","E","K",4,180842,0,47874,4,228716,1.01231513653687,5118
735,"GAG","GAA","E","E",12,180842,2,47874,14,228716,0.839807121523505,5119
735,"GAG","GAG","E","E",180780,180842,47856,47874,228636,228716,1,5120
735,"GAG","GAT","E","D",15,180842,6,47874,21,228716,0.3119781866786,5121
735,"GAG","GGG","E","G",17,180842,5,47874,22,228716,0.489013868652397,5122
735,"GAG","TAG","E",".",14,180842,5,47874,19,228716,0.363247143135968,5123
736,"CAC","AAC","H","N",16,185628,7,45555,23,231183,0.240503922921523,5124
736,"CAC","CAA","H","Q",10,185628,4,45555,14,231183,0.255743038323758,5125
736,"CAC","CAC","H","H",185516,185628,45521,45555,231037,231183,1,5126
736,"CAC","CAG","H","Q",0,185628,1,45555,1,231183,1.40123492233332,5127
736,"CAC","CAT","H","H",22,185628,6,45555,28,231183,0.500794771226314,5128
736,"CAC","CGC","H","R",3,185628,1,45555,4,231183,0.21579152658803,5129
736,"CAC","CTC","H","L",0,185628,1,45555,1,231183,1.40123492233332,5130
736,"CAC","TAC","H","Y",61,185628,14,45555,75,231183,0.707380441029375,5131
737,"GAA","AAA","E","K",12,195569,4,42852,16,238421,0.281058043841677,5132
737,"GAA","CAA","E","Q",2,195569,0,42852,2,238421,0.35911900213294,5133
737,"GAA","GAA","E","E",195539,195569,42843,42852,238382,238421,1,5134
737,"GAA","GAG","E","E",0,195569,1,42852,1,238421,1.39822477680352,5135
737,"GAA","GGA","E","G",3,195569,1,42852,4,238421,0.175657628166789,5136
737,"GAA","TAA","E",".",13,195569,3,42852,16,238421,0.462532968808789,5137
738,"TAT","TAC","Y","Y",1,205723,1,40749,2,246472,0.0384854934332375,5138
738,"TAT","TAT","Y","Y",205719,205723,40748,40749,246467,246472,1,5139
738,"TAT","TCT","Y","S",1,205723,0,40749,1,246472,0.145780844586347,5140
738,"TAT","TGT","Y","C",1,205723,0,40749,1,246472,0.145780844586347,5141
738,"TAT","TTT","Y","F",1,205723,0,40749,1,246472,0.145780844586347,5142
739,"GAG","AAG","E","K",3,208451,2,39670,5,248121,0.0623940583239809,5143
739,"GAG","ATG","E","M",1,208451,0,39670,1,248121,0.13528131391724,5144
739,"GAG","CAG","E","Q",1,208451,0,39670,1,248121,0.13528131391724,5145
739,"GAG","GAA","E","E",6,208451,0,39670,6,248121,1.02047788403455,5146
739,"GAG","GAG","E","E",208384,208451,39655,39670,248039,248121,1,5147
739,"GAG","GAT","E","D",11,208451,6,39670,17,248121,0.101135792684871,5148
739,"GAG","GCG","E","A",1,208451,0,39670,1,248121,0.13528131391724,5149
739,"GAG","GGG","E","G",16,208451,3,39670,19,248121,0.503274003383344,5150
739,"GAG","GTG","E","V",3,208451,1,39670,4,248121,0.13528131391724,5151
739,"GAG","TAG","E",".",25,208451,3,39670,28,248121,0.928247410967866,5152
740,"GAG","AAG","E","K",2,213114,1,38059,3,251173,0.069292331341512,5153
740,"GAG","CAG","E","Q",1,213114,0,38059,1,251173,0.120051227693116,5154
740,"GAG","GAA","E","E",5,213114,1,38059,6,251173,0.252312279252453,5155
740,"GAG","GAG","E","E",213076,213114,38049,38059,251125,251173,1,5156
740,"GAG","GAT","E","D",10,213114,5,38059,15,251173,0.10181742172391,5157
740,"GAG","GGG","E","G",5,213114,1,38059,6,251173,0.252312279252453,5158
740,"GAG","TAG","E",".",15,213114,2,38059,17,251173,0.645560177555478,5159
741,"TTC","ATC","F","I",1,219319,0,37821,1,257140,0.112389671947881,5160
741,"TTC","CTC","F","L",4,219319,0,37821,4,257140,0.55585443240235,5161
741,"TTC","TCC","F","S",7,219319,1,37821,8,257140,0.389196959534576,5162
741,"TTC","TTA","F","L",28,219319,6,37821,34,257140,0.41236620554044,5163
741,"TTC","TTC","F","F",219275,219319,37812,37821,257087,257140,1,5164
741,"TTC","TTG","F","L",1,219319,0,37821,1,257140,0.112389671947881,5165
741,"TTC","TTT","F","F",3,219319,2,37821,5,257140,0.0515160956668442,5166
742,"ATC","AAC","I","N",1,225155,0,36561,1,261716,0.100281228262553,5167
742,"ATC","ACC","I","T",3,225155,0,36561,3,261716,0.352013041965844,5168
742,"ATC","ATA","I","I",22,225155,3,36561,25,261716,0.626939390180475,5169
742,"ATC","ATC","I","I",225124,225155,36557,36561,261681,261716,1,5170
742,"ATC","ATG","I","M",1,225155,0,36561,1,261716,0.100281228262553,5171
742,"ATC","ATT","I","I",3,225155,1,36561,4,261716,0.100281228262553,5172
742,"ATC","GTC","I","V",1,225155,0,36561,1,261716,0.100281228262553,5173
743,"CGT","AGT","R","S",13,232489,4,35414,17,267903,0.167040763134495,5174
743,"CGT","CAA","R","Q",0,232489,1,35414,1,267903,1.39207489323464,5175
743,"CGT","CAT","R","H",77,232489,21,35414,98,267903,0.2557985781264,5176
743,"CGT","CCT","R","P",1,232489,0,35414,1,267903,0.0887032621757095,5177
743,"CGT","CGA","R","R",0,232489,2,35414,2,267903,2.19979782885149,5178
743,"CGT","CGC","R","R",15,232489,1,35414,16,267903,0.909911039696601,5179
743,"CGT","CGT","R","R",232361,232489,35383,35414,267744,267903,1,5180
743,"CGT","CTT","R","L",8,232489,1,35414,9,267903,0.38497596656282,5181
743,"CGT","GGT","R","G",1,232489,0,35414,1,267903,0.0887032621757095,5182
743,"CGT","TGT","R","C",13,232489,1,35414,14,267903,0.75905908912103,5183
744,"AAA","AAA","K","K",236696,236701,32651,32651,269347,269352,1,5184
744,"AAA","CAA","K","Q",2,236701,0,32651,2,269352,0.158087041098216,5185
744,"AAA","GAA","K","E",2,236701,0,32651,2,269352,0.158087041098216,5186
744,"AAA","TAA","K",".",1,236701,0,32651,1,269352,0.0733612109705885,5187
745,"ATT","ACT","I","T",1,240890,0,31373,1,272263,0.0656466246849362,5188
745,"ATT","AGT","I","S",1,240890,0,31373,1,272263,0.0656466246849362,5189
745,"ATT","ATC","I","I",2,240890,1,31373,3,272263,0.037454953802568,5190
745,"ATT","ATT","I","I",240886,240890,31372,31373,272258,272263,1,5191
746,"AGA","AAA","R","K",3,246055,1,28948,4,275003,0.0538842355371522,5192
746,"AGA","ACA","R","T",0,246055,1,28948,1,275003,1.38974853992073,5193
746,"AGA","AGA","R","R",246008,246055,28941,28948,274949,275003,1,5194
746,"AGA","AGG","R","R",11,246055,1,28948,12,275003,0.404305632558493,5195
746,"AGA","AGT","R","S",2,246055,1,28948,3,275003,0.0306663073340772,5196
746,"AGA","ATA","R","I",12,246055,0,28948,12,275003,1.20569002308592,5197
746,"AGA","CGA","R","R",1,246055,1,28948,2,275003,0.0137456989318916,5198
746,"AGA","GGA","R","G",10,246055,2,28948,12,275003,0.170653119964148,5199
746,"AGA","TGA","R",".",8,246055,0,28948,8,275003,0.75192965385776,5200
747,"AGC","AAC","S","N",5,245612,0,26926,5,272538,0.359544812914581,5201
747,"AGC","AGA","S","R",33,245612,7,26926,40,272538,0.19646255045462,5202
747,"AGC","AGC","S","S",245515,245612,26915,26926,272430,272538,1,5203
747,"AGC","AGG","S","R",1,245612,0,26926,1,272538,0.0469553740332908,5204
747,"AGC","AGT","S","S",16,245612,0,26926,16,272538,1.4981567596939,5205
747,"AGC","ATC","S","I",19,245612,1,26926,20,272538,0.789311957199294,5206
747,"AGC","CGC","S","R",3,245612,1,26926,4,272538,0.0469553740332908,5207
747,"AGC","CTA","S","L",0,245612,1,26926,1,272538,1.38929455831561,5208
747,"AGC","GGC","S","G",15,245612,0,26926,15,272538,1.40531608226133,5209
747,"AGC","TGC","S","C",5,245612,1,26926,6,272538,0.102709358692267,5210
748,"GTC","ATC","V","I",14,250422,2,25996,16,276418,0.238554913693614,5211
748,"GTC","GCC","V","A",15,250422,1,25996,16,276418,0.524550013293297,5212
748,"GTC","GTA","V","V",11,250422,1,25996,12,276418,0.327831666836093,5213
748,"GTC","GTC","V","V",250360,250422,25989,25996,276349,276418,1,5214
748,"GTC","GTT","V","V",9,250422,2,25996,11,276418,0.113095885315024,5215
748,"GTC","TTC","V","F",13,250422,1,25996,14,276418,0.423992601270356,5216
749,"CCA","ACA","P","T",19,250998,1,24257,20,275255,0.6597064002509,5217
749,"CCA","CAA","P","Q",18,250998,1,24257,19,275255,0.611469275918451,5218
749,"CCA","CCA","P","P",250932,250998,24253,24257,275185,275255,1,5219
749,"CCA","CCC","P","P",2,250998,0,24257,2,275255,0.0807318787789884,5220
749,"CCA","CCG","P","P",8,250998,0,24257,8,275255,0.563449421149779,5221
749,"CCA","CCT","P","P",1,250998,0,24257,1,275255,0.0366876755374982,5222
749,"CCA","CGA","P","R",2,250998,0,24257,2,275255,0.0807318787789884,5223
749,"CCA","CTA","P","L",11,250998,1,24257,12,275255,0.289920144174685,5224
749,"CCA","TCA","P","S",5,250998,1,24257,6,275255,0.0807318787789884,5225
750,"GTC","ATC","V","I",8,254285,2,22587,10,276872,0.0685674440991397,5226
750,"GTC","CTC","V","L",2,254285,0,22587,2,276872,0.0685674440991397,5227
750,"GTC","GAC","V","D",1,254285,0,22587,1,276872,0.0310562148914825,5228
750,"GTC","GCC","V","A",1,254285,0,22587,1,276872,0.0310562148914825,5229
750,"GTC","GTA","V","V",40,254285,6,22587,46,276872,0.239437056843604,5230
750,"GTC","GTC","V","V",254215,254285,22574,22587,276789,276872,1,5231
750,"GTC","GTT","V","V",17,254285,4,22587,21,276872,0.0973090069748817,5232
750,"GTC","TTC","V","F",1,254285,1,22587,2,276872,0.00785494160272115,5233
751,"GGA","AGA","G","R",16,255819,2,20404,18,276223,0.185838217729025,5234
751,"GGA","GAA","G","E",5,255819,1,20404,6,276223,0.055661939057644,5235
751,"GGA","GCA","G","A",1,255819,0,20404,1,276223,0.0251218805258629,5236
751,"GGA","GGA","G","G",255749,255819,20395,20404,276144,276223,1,5237
751,"GGA","GGG","G","G",11,255819,0,20404,11,276223,0.650157936701224,5238
751,"GGA","GTA","G","V",22,255819,3,20404,25,276223,0.190850314722108,5239
751,"GGA","TGA","G",".",15,255819,3,20404,18,276223,0.0969092427532832,5240
752,"CGT","AGT","R","S",16,256587,0,19935,16,276522,1.00987372344668,5241
752,"CGT","CAT","R","H",39,256587,4,19935,43,276522,0.326777038844873,5242
752,"CGT","CCT","R","P",2,256587,0,19935,2,276522,0.0529249194403696,5243
752,"CGT","CGA","R","R",2,256587,0,19935,2,276522,0.0529249194403696,5244
752,"CGT","CGC","R","R",9,256587,0,19935,9,276522,0.472434567421157,5245
752,"CGT","CGG","R","R",6,256587,0,19935,6,276522,0.259211741960174,5246
752,"CGT","CGT","R","R",256489,256587,19931,19935,276420,276522,1,5247
752,"CGT","CTT","R","L",14,256587,0,19935,14,276522,0.858136914914901,5248
752,"CGT","TGT","R","C",10,256587,0,19935,10,276522,0.54853289684449,5249
753,"TGT","CGT","C","R",7,260134,0,18515,7,278649,0.280874373275297,5250
753,"TGT","GGT","C","G",9,260134,0,18515,9,278649,0.409921027837786,5251
753,"TGT","TAT","C","Y",5,260134,0,18515,5,278649,0.167556052570458,5252
753,"TGT","TGC","C","C",6,260134,1,18515,7,278649,0.0602204009878298,5253
753,"TGT","TGT","C","C",260090,260134,18513,18515,278603,278649,1,5254
753,"TGT","TTT","C","F",17,260134,1,18515,18,278649,0.34389180233818,5255
754,"TTG","ATG","L","M",0,260230,1,16413,1,276643,1.38728831738382,5256
754,"TTG","CTG","L","L",5,260230,0,16413,5,276643,0.133832098080626,5257
754,"TTG","TAG","L",".",2,260230,0,16413,2,276643,0.0351742820725711,5258
754,"TTG","TCG","L","S",3,260230,1,16413,4,276643,0.0157859500955738,5259
754,"TTG","TTA","L","L",9,260230,1,16413,10,276643,0.0948055436026076,5260
754,"TTG","TTG","L","L",260171,260230,16408,16413,276579,276643,1,5261
754,"TTG","TTT","L","F",40,260230,2,16413,42,276643,0.555587654404937,5262
755,"ACC","AAC","T","N",13,257395,3,64205,16,321600,0.56664094967829,5263
755,"ACC","ACA","T","T",30,257395,6,64205,36,321600,0.797733174326601,5264
755,"ACC","ACC","T","T",257284,257395,64182,64205,321466,321600,1,5265
755,"ACC","ACG","T","T",3,257395,1,64205,4,321600,0.222284359297308,5266
755,"ACC","ACT","T","T",9,257395,3,64205,12,321600,0.328546346210419,5267
755,"ACC","ATC","T","I",20,257395,2,64205,22,321600,1.3985561947647,5268
755,"ACC","CCC","T","P",1,257395,0,64205,1,321600,0.222284359297308,5269
755,"ACC","GCC","T","A",32,257395,8,64205,40,321600,0.607953892551448,5270
755,"ACC","TCC","T","S",3,257395,0,64205,3,321600,0.690997814784547,5271
756,"CTC","ATC","L","I",20,247081,8,73262,28,320343,0.391092558698506,5272
756,"CTC","CAC","L","H",1,247081,0,73262,1,320343,0.301304674813454,5273
756,"CTC","CCC","L","P",38,247081,13,73262,51,320343,0.520080371521906,5274
756,"CTC","CGC","L","R",0,247081,1,73262,1,320343,1.40803268015937,5275
756,"CTC","CTA","L","L",17,247081,6,73262,23,320343,0.458216419231559,5276
756,"CTC","CTC","L","L",246997,247081,73231,73262,320228,320343,1,5277
756,"CTC","CTG","L","L",1,247081,0,73262,1,320343,0.301304674813454,5278
756,"CTC","CTT","L","L",2,247081,1,73262,3,320343,0.180475570332512,5279
756,"CTC","TTC","L","F",5,247081,2,73262,7,320343,0.301304674813454,5280
757,"CCC","ACC","P","T",8,233538,8,82059,16,315597,0.116395084142618,5281
757,"CCC","CAC","P","H",10,233538,6,82059,16,315597,0.266065352912957,5282
757,"CCC","CCA","P","P",21,233538,5,82059,26,315597,0.978167219433498,5283
757,"CCC","CCC","P","P",233471,233538,82027,82059,315498,315597,1,5284
757,"CCC","CCG","P","P",3,233538,0,82059,3,315597,1.09025553554272,5285
757,"CCC","CCT","P","P",9,233538,7,82059,16,315597,0.176365885128671,5286
757,"CCC","CTC","P","L",8,233538,2,82059,10,315597,0.747141275458812,5287
757,"CCC","GCC","P","A",1,233538,0,82059,1,315597,0.401295460935418,5288
757,"CCC","TCC","P","S",7,233538,4,82059,11,315597,0.274600991243215,5289
758,"GCG","ACG","A","T",33,222811,17,94934,50,317745,0.499241732077914,5290
758,"GCG","CCG","A","P",1,222811,0,94934,1,317745,0.545740011246911,5291
758,"GCG","GAG","A","E",19,222811,18,94934,37,317745,0.183217988744061,5292
758,"GCG","GCA","A","A",29,222811,11,94934,40,317745,0.758089734546117,5293
758,"GCG","GCG","A","A",222685,222811,94862,94934,317547,317745,1,5294
758,"GCG","GCT","A","A",13,222811,6,94934,19,317745,0.545740011246911,5295
758,"GCG","GTG","A","V",15,222811,12,94934,27,317745,0.242860992921585,5296
758,"GCG","TCG","A","S",16,222811,8,94934,24,317745,0.499241732077914,5297
759,"TTT","ATT","F","I",3,208367,8,105621,11,313988,1.67135790155563,5298
759,"TTT","CTT","F","L",3,208367,2,105621,5,313988,0.376164264644748,5299
759,"TTT","TAT","F","Y",0,208367,1,105621,1,313988,1.44853793005358,5300
759,"TTT","TCT","F","S",1,208367,2,105621,3,313988,0.919041384501585,5301
759,"TTT","TTA","F","L",6,208367,1,105621,7,313988,1.42235014297635,5302
759,"TTT","TTC","F","F",0,208367,4,105621,4,313988,3.22909883528779,5303
759,"TTT","TTG","F","L",1,208367,2,105621,3,313988,0.919041384501585,5304
759,"TTT","TTT","F","F",208353,208367,105601,105621,313954,313988,1,5305
760,"TCA","CCA","S","P",4,199376,3,122114,7,321490,0.461387159056093,5306
760,"TCA","GCA","S","A",0,199376,1,122114,1,321490,1.47595557878539,5307
760,"TCA","TAA","S",".",27,199376,11,122114,38,321490,1.11278972974505,5308
760,"TCA","TCA","S","S",199319,199376,122092,122114,321411,321490,1,5309
760,"TCA","TCG","S","S",11,199376,3,122114,14,321490,1.4763479639718,5310
760,"TCA","TCT","S","S",1,199376,0,122114,1,321490,0.916634094173155,5311
760,"TCA","TGA","S",".",2,199376,2,122114,4,321490,0.318609819506373,5312
760,"TCA","TTA","S","L",8,199376,2,122114,10,321490,1.4763479639718,5313
760,"TCA","TTT","S","F",4,199376,0,122114,4,321490,2.3399161330992,5314
761,"ACT","AAT","T","N",4,181308,5,131374,9,312682,0.675505932592804,5315
761,"ACT","ACA","T","T",2,181308,1,131374,3,312682,0.77992584997109,5316
761,"ACT","ACC","T","T",1,181308,1,131374,2,312682,0.422012046410554,5317
761,"ACT","ACT","T","T",181287,181308,131358,131374,312645,312682,1,5318
761,"ACT","AGT","T","S",1,181308,2,131374,3,312682,1.02066043928574,5319
761,"ACT","ATT","T","I",3,181308,0,131374,3,312682,2.24075546809655,5320
761,"ACT","CCT","T","P",0,181308,2,131374,2,312682,2.25392274470145,5321
761,"ACT","GCT","T","A",6,181308,5,131374,11,312682,0.539191447506511,5322
761,"ACT","TCT","T","S",4,181308,0,131374,4,312682,2.64799387886008,5323
762,"CTA","ATA","L","I",23,169057,16,148740,39,317797,0.933352668884272,5324
762,"CTA","CAA","L","Q",2,169057,0,148740,2,317797,2.07539628770036,5325
762,"CTA","CCA","L","P",5,169057,0,148740,5,317797,3.3628311659569,5326
762,"CTA","CGA","L","R",0,169057,1,148740,1,317797,1.56322417094944,5327
762,"CTA","CTA","L","L",169022,169057,148719,148740,317741,317797,1,5328
762,"CTA","CTC","L","L",0,169057,1,148740,1,317797,1.56322417094944,5329
762,"CTA","CTG","L","L",1,169057,2,148740,3,317797,1.10664304220213,5330
762,"CTA","CTT","L","L",3,169057,0,148740,3,317797,2.59428618984479,5331
762,"CTA","TTA","L","L",1,169057,1,148740,2,317797,0.5733435634224,5332
763,"CGC","AGC","R","S",7,153714,6,161041,13,314755,0.796289736229103,5333
763,"CGC","CAC","R","H",35,153714,33,161041,68,314755,0.709160136902553,5334
763,"CGC","CCC","R","P",1,153714,0,161041,1,314755,1.59151351293784,5335
763,"CGC","CGA","R","R",13,153714,18,161041,31,314755,0.985159201521051,5336
763,"CGC","CGC","R","R",153629,153714,160943,161041,314572,314755,1,5337
763,"CGC","CGG","R","R",0,153714,1,161041,1,314755,1.53572802056659,5338
763,"CGC","CGT","R","R",8,153714,7,161041,15,314755,0.777856567789117,5339
763,"CGC","CTC","R","L",9,153714,14,161041,23,314755,1.1151897793374,5340
763,"CGC","TGC","R","C",12,153714,19,161041,31,314755,1.14950519791109,5341
764,"AGG","AAG","R","K",6,140797,3,175183,9,315980,1.31060403018546,5342
764,"AGG","ACG","R","T",1,140797,0,175183,1,315980,1.53598791468192,5343
764,"AGG","AGA","R","R",1,140797,3,175183,4,315980,1.27638242482607,5344
764,"AGG","AGC","R","S",2,140797,0,175183,2,315980,2.26653430535529,5345
764,"AGG","AGG","R","R",140764,140797,175148,175183,315912,315980,1,5346
764,"AGG","AGT","R","S",9,140797,14,175183,23,315980,0.897435816203772,5347
764,"AGG","ATG","R","M",5,140797,6,175183,11,315980,0.63082454967835,5348
764,"AGG","CGG","R","R",0,140797,1,175183,1,315980,1.27638242482607,5349
764,"AGG","GGG","R","G",8,140797,7,175183,15,315980,0.647908168931265,5350
764,"AGG","TGG","R","W",1,140797,1,175183,2,315980,0.498295263218823,5351
765,"AAA","AAA","K","K",121502,121506,186656,186658,308158,308164,1,5352
765,"AAA","AAC","K","N",1,121506,0,186658,1,308164,1.48698239930865,5353
765,"AAA","AAT","K","N",0,121506,2,186658,2,308164,1.57143212843443,5354
765,"AAA","ACA","K","T",2,121506,0,186658,2,308164,2.24323058553866,5355
765,"AAA","AGA","K","R",1,121506,0,186658,1,308164,1.48698239930865,5356
766,"TGG","CGG","W","R",1,105607,1,212806,2,318413,0.220095877955748,5357
766,"TGG","GGG","W","G",3,105607,0,212806,3,318413,2.78785880184283,5358
766,"TGG","TAG","W",".",8,105607,3,212806,11,318413,1.66934626981407,5359
766,"TGG","TGA","W",".",0,105607,1,212806,1,318413,0.685510510489442,5360
766,"TGG","TGC","W","C",2,105607,2,212806,4,318413,0.220095877955748,5361
766,"TGG","TGG","W","W",105580,105607,212786,212806,318366,318413,1,5362
766,"TGG","TGT","W","C",3,105607,9,212806,12,318413,0.931662497592481,5363
766,"TGG","TTG","W","L",10,105607,4,212806,14,318413,1.62653024423547,5364
767,"TTG","ATG","L","M",0,91547,1,222908,1,314455,0.515604423757167,5365
767,"TTG","CTG","L","L",4,91547,4,222908,8,314455,0.15586001688736,5366
767,"TTG","TCG","L","S",0,91547,1,222908,1,314455,0.515604423757167,5367
767,"TTG","TGG","L","W",0,91547,8,222908,8,314455,2.68523663863622,5368
767,"TTG","TTA","L","L",7,91547,6,222908,13,314455,0.38851224872503,5369
767,"TTG","TTG","L","L",91533,91547,222880,222908,314413,314455,1,5370
767,"TTG","TTT","L","F",3,91547,8,222908,11,314455,0.617266934107657,5371
768,"GAC","AAC","D","N",3,74486,2,238297,5,312783,0.628859260750731,5372
768,"GAC","CAC","D","H",0,74486,3,238297,3,312783,0.9412075290895,5373
768,"GAC","GAA","D","E",5,74486,8,238297,13,312783,0.198692942044179,5374
768,"GAC","GAC","D","D",74468,74486,238256,238297,312724,312783,1,5375
768,"GAC","GAG","D","E",1,74486,0,238297,1,312783,1.41042392708139,5376
768,"GAC","GAT","D","D",1,74486,0,238297,1,312783,1.41042392708139,5377
768,"GAC","GGC","D","G",1,74486,7,238297,8,312783,0.9412075290895,5378
768,"GAC","TAC","D","Y",7,74486,21,238297,28,312783,0.553193465682714,5379
769,"TCC","CCC","S","P",2,61664,10,251403,12,313067,0.592699496302581,5380
769,"TCC","GCC","S","A",0,61664,1,251403,1,313067,0.215638665001073,5381
769,"TCC","TAC","S","Y",5,61664,24,251403,29,313067,0.715155821647161,5382
769,"TCC","TCA","S","S",6,61664,13,251403,19,313067,0.215638665001073,5383
769,"TCC","TCC","S","S",61651,61664,251350,251403,313001,313067,1,5384
769,"TCC","TCT","S","S",0,61664,3,251403,3,313067,0.674278290017582,5385
769,"TCC","TGC","S","C",0,61664,1,251403,1,313067,0.215638665001073,5386
769,"TCC","TTC","S","F",0,61664,1,251403,1,313067,0.215638665001073,5387
770,"TTT","ATT","F","I",2,49446,7,266961,9,316407,0.218249537296456,5388
770,"TTT","CTT","F","L",11,49446,53,266961,64,316407,0.527408977307015,5389
770,"TTT","GTT","F","V",1,49446,0,266961,1,316407,1.39483232767225,5390
770,"TTT","TAT","F","Y",0,49446,1,266961,1,316407,0.128562332462511,5391
770,"TTT","TCT","F","S",1,49446,1,266961,2,316407,0.0337230089818958,5392
770,"TTT","TGT","F","C",2,49446,0,266961,2,316407,2.20102823157072,5393
770,"TTT","TTC","F","F",0,49446,1,266961,1,316407,0.128562332462511,5394
770,"TTT","TTG","F","L",1,49446,0,266961,1,316407,1.39483232767225,5395
770,"TTT","TTT","F","F",49428,49446,266898,266961,316326,316407,1,5396
