coverage,wt.counts,mut.count,s.count,ns.count,stp.count,aa.sampled,codons.sampled
3871520,3864093,7427,0,7016,411,19,54
3908952,3904712,4240,0,4159,81,20,54
3902100,3897057,5043,0,4891,152,20,54
3868710,3861561,7149,0,6993,156,19,54
3799881,3792742,7139,0,6954,185,20,54
3884926,3875777,9149,275,8775,99,20,54
3902101,3893509,8592,0,8378,214,19,54
3915488,3903972,11516,0,11250,266,19,54
3859731,3852793,6938,0,6815,123,18,54
3928409,3921957,6452,0,6175,277,20,54
3908441,3901560,6881,0,6648,233,19,54
3953232,3947526,5706,0,5609,97,20,54
3638669,3631873,6796,0,6449,347,19,54
3609297,3604059,5238,0,5138,100,19,53
3572673,3562504,10169,0,9841,328,20,54
3564379,3558977,5402,297,4955,150,18,54
3490377,3487386,2991,18,2904,69,19,43
2380170,2376675,3495,0,3410,85,19,54
2454896,2451389,3507,0,3425,82,20,54
2497565,2494416,3149,222,2835,92,20,53
2531798,2529555,2243,0,2209,34,20,54
2524167,2522950,1217,0,1202,15,19,54
2585663,2584449,1214,7,1142,65,20,49
2617374,2613796,3578,0,3464,114,19,54
2639679,2636309,3370,0,3281,89,19,53
2664974,2661879,3095,0,3027,68,19,54
2722441,2718089,4352,0,4307,45,20,54
2693548,2689220,4328,0,4156,172,20,54
2704883,2700423,4460,0,4380,80,19,54
2682439,2678287,4152,0,3922,230,19,54
2651917,2649042,2875,0,2819,56,19,54
2534196,2531174,3022,0,2954,68,20,54
2525160,2522858,2302,0,2262,40,20,54
2481848,2479227,2621,0,2582,39,18,54
2515004,2512252,2752,0,2680,72,19,54
2534488,2532814,1674,0,1633,41,20,54
2412700,2410819,1881,0,1818,63,19,53
2389664,2387635,2029,47,1916,66,20,54
2404592,2401397,3195,0,3107,88,19,54
2364581,2360768,3813,104,3654,55,20,54
2356833,2354233,2600,0,2515,85,20,54
2348080,2346917,1163,0,1100,63,19,53
2341866,2339568,2298,24,2236,38,19,54
2297633,2295532,2101,0,2051,50,19,54
2276160,2273553,2607,0,2547,60,19,54
2256367,2251047,5320,0,5106,214,20,54
2255019,2251075,3944,0,3841,103,20,54
2194329,2190330,3999,0,3859,140,19,54
2184254,2181972,2282,0,2228,54,19,53
2156047,2154647,1400,0,1374,26,20,54
2140504,2138554,1950,0,1899,51,20,54
2092710,2089919,2791,0,2774,17,18,54
2092379,2088518,3861,0,3603,258,20,54
2040825,2038438,2387,0,2232,155,20,54
2003456,2000932,2524,0,2462,62,19,54
1976167,1973379,2788,0,2697,91,20,54
1950014,1948167,1847,0,1772,75,19,54
1930859,1929165,1694,0,1671,23,18,52
1896215,1893909,2306,0,2218,88,19,54
1852070,1849389,2681,0,2538,143,19,54
1859091,1856161,2930,0,2807,123,19,54
1821540,1819464,2076,0,2003,73,19,54
1795808,1794630,1178,0,1129,49,18,47
1765280,1763076,2204,37,2157,10,20,54
1720257,1717422,2835,25,2755,55,20,54
1694548,1692892,1656,0,1587,69,20,54
1686131,1684187,1944,0,1870,74,20,54
1692780,1690564,2216,43,2066,107,20,54
1661965,1659389,2576,0,2462,114,19,54
1646007,1643586,2421,73,2293,55,19,53
1665396,1663455,1941,0,1855,86,20,54
1673541,1671934,1607,0,1520,87,20,54
1668648,1668183,465,0,451,14,19,47
1643122,1640926,2196,0,2161,35,19,54
1639158,1637420,1738,0,1693,45,19,54
1634477,1631966,2511,0,2460,51,19,54
1635719,1632980,2739,0,2707,32,20,54
1623323,1620762,2561,0,2514,47,20,54
1590886,1587915,2971,188,2671,112,20,54
1581147,1578858,2289,0,2202,87,19,54
1563112,1560418,2694,226,2427,41,18,54
1560112,1558480,1632,0,1584,48,20,53
1568047,1565579,2468,164,2230,74,20,54
1581663,1579441,2222,43,2163,16,20,54
1594300,1591820,2480,0,2417,63,19,54
1607752,1603561,4191,0,4039,152,20,54
1619305,1616983,2322,112,2167,43,19,54
1635768,1633304,2464,0,2407,57,20,54
1652682,1651437,1245,0,1213,32,19,53
1651128,1649506,1622,68,1507,47,19,52
1651064,1649116,1948,0,1875,73,20,54
1670033,1668082,1951,0,1857,94,19,54
1692048,1689542,2506,0,2458,48,19,53
1708364,1706446,1918,0,1812,106,20,53
1724815,1722296,2519,0,2422,97,19,54
1724146,1720960,3186,0,3105,81,19,54
1736546,1734554,1992,0,1952,40,19,54
1761666,1760732,934,0,911,23,20,53
1756846,1754856,1990,0,1881,109,19,54
1743388,1741530,1858,0,1739,119,19,53
1746352,1744113,2239,0,2149,90,19,54
1740983,1738818,2165,0,2130,35,19,54
1726677,1724943,1734,0,1676,58,20,54
1707267,1704309,2958,0,2934,24,20,54
1697222,1694453,2769,0,2736,33,20,54
1676354,1674771,1583,0,1524,59,20,53
1719706,1718187,1519,0,1507,12,19,54
1708073,1706132,1941,0,1879,62,20,54
1701051,1698921,2130,0,2094,36,19,54
1710616,1708867,1749,0,1734,15,20,54
1716473,1714448,2025,10,1920,95,20,54
1700692,1698453,2239,0,2197,42,18,54
1692015,1689120,2895,0,2834,61,19,54
1731795,1730120,1675,122,1527,26,19,53
1749829,1748005,1824,0,1801,23,19,54
1752337,1750554,1783,0,1727,56,20,54
1769782,1767714,2068,0,2002,66,20,54
1783309,1781393,1916,0,1831,85,20,54
1804107,1802182,1925,0,1912,13,19,54
1831127,1829505,1622,0,1572,50,19,53
1825741,1822808,2933,0,2894,39,19,54
1833553,1831759,1794,0,1732,62,20,54
1835021,1832936,2085,0,2018,67,20,54
1862260,1859516,2744,0,2690,54,19,54
1862257,1860173,2084,0,2006,78,20,54
1866720,1865061,1659,0,1579,80,19,53
1877355,1874118,3237,0,3042,195,20,54
1901308,1899150,2158,0,2077,81,20,52
1896168,1894652,1516,0,1467,49,20,52
1891253,1888458,2795,0,2747,48,19,54
1886283,1884305,1978,134,1820,24,18,54
1891543,1889659,1884,0,1836,48,20,53
1873471,1871405,2066,0,2038,28,20,54
1874302,1872327,1975,0,1843,132,20,54
1858262,1856290,1972,12,1925,35,20,54
1836947,1835377,1570,0,1538,32,18,53
1842220,1840731,1489,38,1378,73,20,54
1847056,1844889,2167,0,2100,67,19,54
1853919,1852658,1261,0,1244,17,19,52
1863570,1862468,1102,0,1081,21,19,51
1870432,1869365,1067,0,1034,33,19,53
1849908,1848263,1645,0,1612,33,19,54
1850342,1849371,971,0,930,41,20,53
1885359,1883840,1519,39,1452,28,20,54
1898746,1897437,1309,0,1292,17,20,54
1895282,1894391,891,0,828,63,19,51
1890294,1889799,495,0,480,15,19,48
1893675,1892358,1317,0,1302,15,19,54
1871093,1868907,2186,0,2172,14,19,54
1857280,1855239,2041,0,2030,11,18,54
1846015,1844317,1698,10,1623,65,19,52
1834110,1833011,1099,0,1044,55,20,54
1800705,1799209,1496,0,1449,47,18,52
1789973,1787802,2171,0,2090,81,20,54
1810407,1808168,2239,172,2062,5,17,53
1789255,1787549,1706,37,1648,21,19,53
1767180,1765574,1606,0,1554,52,19,54
1738528,1736429,2099,105,1967,27,19,54
1728226,1726209,2017,0,1993,24,20,52
1711910,1710727,1183,10,1127,46,19,53
1719140,1717700,1440,0,1372,68,20,54
1724179,1722217,1962,0,1939,23,19,54
1703621,1701548,2073,0,2048,25,19,54
1688741,1686867,1874,0,1831,43,19,54
1684393,1682581,1812,0,1721,91,18,51
1704657,1702326,2331,0,2296,35,19,54
1704632,1702118,2514,0,2493,21,19,53
1667480,1666113,1367,0,1320,47,19,50
1668549,1666227,2322,0,2291,31,20,54
1645362,1642581,2781,93,2670,18,19,54
1646841,1645225,1616,0,1576,40,20,54
1638560,1636385,2175,72,2057,46,20,53
1627195,1625380,1815,0,1740,75,20,54
1623366,1621028,2338,0,2276,62,19,54
1651889,1650615,1274,0,1250,24,20,54
1659182,1657244,1938,0,1835,103,20,54
1644587,1642749,1838,0,1799,39,20,53
1639998,1638322,1676,0,1647,29,19,54
1644846,1643583,1263,0,1226,37,19,54
1648303,1647484,819,0,807,12,19,51
1636123,1634912,1211,0,1195,16,18,53
1626169,1625175,994,0,963,31,19,54
1611907,1610806,1101,0,1069,32,20,54
1607623,1606719,904,32,820,52,20,53
1611621,1610541,1080,0,1050,30,18,52
1619759,1618686,1073,0,1009,64,20,54
1630199,1629509,690,0,674,16,19,50
1620937,1620078,859,0,839,20,19,53
1597026,1595255,1771,0,1753,18,20,52
1596410,1593915,2495,0,2446,49,19,53
1625239,1623307,1932,107,1804,21,17,54
1616910,1615196,1714,5,1655,54,20,54
1600307,1598218,2089,0,2010,79,20,54
1577785,1576001,1784,0,1735,49,19,54
1588463,1587136,1327,0,1289,38,19,53
1598030,1596757,1273,0,1192,81,20,54
1579508,1577713,1795,0,1736,59,20,54
1558394,1555500,2894,0,2854,40,19,54
1554605,1553234,1371,0,1306,65,20,54
1551256,1549486,1770,0,1749,21,19,53
1539159,1537954,1205,0,1164,41,19,54
1549085,1548032,1053,0,1012,41,20,54
1561375,1560402,973,0,921,52,19,54
1548648,1548092,556,0,520,36,20,54
1532434,1531350,1084,0,1054,30,19,54
1535160,1532875,2285,19,2197,69,20,54
1571202,1570392,810,0,792,18,17,49
1550486,1549057,1429,0,1390,39,19,54
1577673,1576461,1212,0,1168,44,20,54
1577792,1577041,751,0,732,19,20,53
1584576,1583359,1217,39,1146,32,20,54
1596216,1593911,2305,269,1958,78,20,54
1581420,1579058,2362,0,2303,59,19,52
1566730,1564450,2280,0,2260,20,19,54
1559023,1558102,921,72,828,21,17,48
1550172,1549136,1036,14,1005,17,19,53
1546386,1545488,898,0,872,26,19,53
1521439,1520497,942,0,918,24,20,54
1539679,1538750,929,0,881,48,19,53
1544585,1543369,1216,90,1079,47,20,54
1527549,1525722,1827,0,1790,37,20,54
1510713,1509736,977,0,947,30,18,53
1506529,1506283,246,0,246,0,15,41
1524319,1523107,1212,0,1141,71,20,54
1535161,1533897,1264,0,1243,21,20,54
1526583,1525277,1306,0,1263,43,19,54
1504389,1503623,766,0,745,21,18,47
1507606,1506853,753,0,715,38,20,54
1510417,1508649,1768,0,1692,76,20,54
1520588,1519534,1054,0,1035,19,19,52
1524794,1523375,1419,26,1336,57,20,54
1525514,1524274,1240,0,1214,26,19,54
1543294,1541672,1622,57,1519,46,20,54
1529352,1528088,1264,0,1207,57,19,53
1505900,1504981,919,0,901,18,18,54
1519377,1516828,2549,188,2295,66,17,54
1526572,1525119,1453,0,1387,66,20,53
1524217,1522981,1236,0,1216,20,19,54
1504045,1502623,1422,79,1303,40,18,54
1498198,1496781,1417,0,1376,41,19,54
1505206,1503640,1566,0,1546,20,19,54
1497336,1495577,1759,0,1745,14,20,54
1484215,1482305,1910,0,1865,45,19,54
1475157,1472133,3024,0,2970,54,20,54
1482452,1480389,2063,0,1994,69,20,54
1463756,1461838,1918,0,1832,86,19,54
1467057,1465663,1394,0,1369,25,19,54
1435224,1433265,1959,0,1925,34,19,54
1422603,1420371,2232,0,2187,45,20,54
1423207,1420917,2290,0,2247,43,20,54
1416127,1414503,1624,0,1597,27,20,54
1409755,1409138,617,0,605,12,19,48
1407905,1406048,1857,44,1720,93,20,54
1417111,1416339,772,0,756,16,20,53
1432005,1431286,719,0,688,31,19,52
1442636,1441766,870,0,828,42,20,54
1456753,1455586,1167,0,1129,38,20,52
1443508,1442281,1227,0,1195,32,19,54
1449672,1447653,2019,0,1953,66,19,53
1456871,1455482,1389,0,1382,7,19,54
1453614,1451869,1745,0,1701,44,19,54
1472535,1470805,1730,0,1670,60,19,54
1479346,1477899,1447,22,1349,76,20,54
1483351,1482243,1108,33,1022,53,20,53
1491666,1490436,1230,0,1179,51,20,52
1490003,1489013,990,0,960,30,19,54
1491581,1490508,1073,0,1031,42,19,54
1494225,1492115,2110,168,1881,61,20,54
1499491,1497691,1800,0,1756,44,20,54
1499342,1497679,1663,0,1570,93,20,54
1483405,1482529,876,0,857,19,19,53
1488560,1487319,1241,0,1215,26,19,54
1497461,1496459,1002,0,990,12,19,54
1505265,1504192,1073,0,1035,38,20,52
1513483,1512067,1416,0,1405,11,20,54
1496915,1496104,811,0,782,29,20,52
1496813,1495881,932,0,911,21,19,54
1509372,1508085,1287,76,1186,25,20,54
1510871,1510042,829,0,800,29,18,50
1504928,1503725,1203,0,1192,11,19,53
1507520,1506038,1482,0,1383,99,19,54
1507186,1506048,1138,0,1111,27,19,53
1501929,1501027,902,0,867,35,18,53
1488226,1487111,1115,0,1052,63,19,52
1499748,1498575,1173,0,1126,47,20,54
1500762,1499617,1145,81,1043,21,18,53
1511588,1510733,855,0,827,28,19,52
1519954,1518373,1581,0,1543,38,19,52
1521542,1520533,1009,0,946,63,17,52
1522606,1521238,1368,0,1323,45,20,54
1540163,1538834,1329,0,1301,28,20,54
1544136,1542960,1176,19,1119,38,20,54
1555218,1554064,1154,0,1090,64,19,53
1559837,1557857,1980,0,1867,113,20,54
1552286,1550945,1341,0,1283,58,19,53
1545657,1544308,1349,0,1303,46,20,53
1562315,1561078,1237,0,1213,24,20,54
1572375,1570184,2191,0,2078,113,20,54
1583572,1582097,1475,0,1417,58,20,54
1568608,1566826,1782,11,1718,53,20,53
1573805,1571883,1922,0,1855,67,19,54
1567690,1564859,2831,0,2795,36,20,54
1584369,1581972,2397,0,2372,25,19,54
1580517,1578999,1518,0,1478,40,20,54
1592840,1591276,1564,0,1498,66,19,54
1596812,1595068,1744,59,1614,71,20,54
1606480,1604477,2003,0,1941,62,20,54
1604525,1603012,1513,0,1457,56,19,54
1612504,1610833,1671,0,1651,20,20,54
1619628,1617262,2366,0,2307,59,20,54
1617120,1615126,1994,0,1943,51,20,54
1622642,1621730,912,0,878,34,19,53
1623012,1620174,2838,0,2690,148,19,54
1628685,1625955,2730,0,2615,115,20,54
1636288,1634314,1974,0,1917,57,19,54
1630549,1628708,1841,0,1754,87,19,53
1624043,1621976,2067,0,2025,42,20,54
1613764,1611849,1915,0,1848,67,20,54
1624265,1622630,1635,0,1535,100,19,54
1636324,1634378,1946,0,1927,19,19,54
1636302,1633969,2333,0,2249,84,20,54
1633315,1631509,1806,0,1773,33,19,54
1622443,1620905,1538,0,1524,14,20,54
1590257,1588757,1500,0,1430,70,19,54
1596253,1594265,1988,0,1932,56,19,54
1586578,1584989,1589,115,1455,19,19,53
1600789,1598935,1854,62,1759,33,20,54
1596239,1593841,2398,135,2241,22,19,54
1585960,1584508,1452,0,1418,34,20,54
1576920,1575321,1599,0,1562,37,19,54
1592194,1590554,1640,0,1591,49,19,54
1583895,1582391,1504,0,1474,30,19,54
1576245,1574653,1592,0,1552,40,20,54
1599967,1598054,1913,70,1823,20,19,54
1616561,1614059,2502,0,2424,78,20,54
1604570,1601756,2814,0,2682,132,20,54
1610533,1608337,2196,0,2083,113,19,54
1626407,1624471,1936,0,1830,106,19,54
1639919,1637292,2627,0,2551,76,20,54
1635654,1634169,1485,0,1447,38,20,54
1630425,1629535,890,0,871,19,19,53
1626453,1625222,1231,90,1118,23,20,54
1637907,1636420,1487,0,1467,20,19,54
1634330,1631965,2365,0,2312,53,19,54
1641830,1640074,1756,0,1690,66,20,54
1642208,1639195,3013,5,2950,58,19,54
1657645,1655942,1703,0,1637,66,20,54
1643429,1642685,744,16,723,5,20,51
1639995,1638657,1338,0,1266,72,19,53
1646676,1645658,1018,0,964,54,19,54
1666628,1664673,1955,0,1852,103,20,54
1681151,1678116,3035,0,2956,79,19,54
1690464,1688959,1505,36,1452,17,20,54
1695103,1693704,1399,0,1369,30,20,54
1712585,1711200,1385,35,1290,60,20,54
1733289,1731819,1470,0,1399,71,20,54
1752789,1750352,2437,0,2343,94,19,54
1741953,1740049,1904,0,1843,61,20,54
1749438,1746673,2765,0,2706,59,19,54
1738510,1736660,1850,0,1823,27,20,54
1733073,1731024,2049,0,1951,98,19,54
1749199,1746731,2468,0,2338,130,20,54
1762774,1761121,1653,0,1608,45,20,53
1752263,1750383,1880,0,1803,77,20,54
1740597,1739083,1514,0,1478,36,19,52
1738029,1737335,694,0,667,27,19,52
1755645,1755098,547,57,483,7,18,51
1633668,1632618,1050,0,984,66,19,54
1744902,1743004,1898,0,1835,63,20,54
1740059,1738875,1184,0,1151,33,20,54
1735883,1734383,1500,0,1468,32,19,54
1747547,1746330,1217,0,1194,23,19,54
1740144,1738645,1499,0,1480,19,19,54
1738943,1737478,1465,0,1427,38,19,54
1738601,1736894,1707,80,1589,38,17,54
1751607,1749795,1812,0,1711,101,19,54
1745344,1744045,1299,0,1268,31,19,53
1734542,1733378,1164,0,1121,43,19,53
1728414,1726722,1692,0,1635,57,20,54
1737117,1734737,2380,0,2367,13,19,54
1738898,1736815,2083,0,2001,82,20,54
1741332,1739993,1339,0,1283,56,19,53
1748225,1746532,1693,51,1613,29,19,53
1737835,1736474,1361,0,1311,50,20,54
1752218,1751422,796,0,785,11,20,52
1764150,1762926,1224,0,1180,44,20,53
1783063,1781928,1135,0,1119,16,20,50
1786349,1785144,1205,0,1174,31,19,54
1786743,1785299,1444,0,1401,43,19,53
1764531,1762049,2482,0,2348,134,20,54
1778519,1776211,2308,0,2257,51,20,54
1774838,1773466,1372,0,1336,36,19,52
1776389,1774686,1703,0,1680,23,18,54
1777210,1776129,1081,0,1050,31,20,51
1783770,1782415,1355,0,1315,40,19,54
1789714,1787828,1886,62,1765,59,20,54
1802860,1801265,1595,0,1486,109,19,54
1820491,1817960,2531,0,2485,46,19,54
1835472,1834059,1413,0,1364,49,20,53
1843977,1842370,1607,0,1569,38,20,54
1860031,1858522,1509,0,1480,29,19,54
1864687,1863106,1581,0,1523,58,19,54
1857731,1855890,1841,0,1775,66,20,53
1875576,1874538,1038,0,995,43,19,52
1874018,1873128,890,73,774,43,20,54
1872048,1871183,865,30,789,46,20,52
1868807,1868186,621,0,592,29,19,52
1856950,1856203,747,0,719,28,18,53
1858885,1857341,1544,0,1524,20,20,54
1880970,1879512,1458,30,1356,72,20,54
1917529,1915510,2019,0,1993,26,20,54
1916720,1913981,2739,0,2655,84,19,54
1906032,1904675,1357,0,1257,100,19,52
1917626,1916687,939,0,900,39,20,53
1881996,1880057,1939,0,1791,148,20,54
1891209,1889954,1255,0,1200,55,20,53
1892069,1890224,1845,0,1755,90,20,54
1899732,1898005,1727,0,1656,71,20,54
1901161,1899400,1761,15,1678,68,19,54
1900097,1898469,1628,0,1579,49,19,54
1889279,1887352,1927,0,1889,38,20,54
1883350,1881487,1863,0,1789,74,19,54
1917983,1914949,3034,0,2980,54,20,54
1926011,1921657,4354,107,4222,25,20,54
1886140,1884074,2066,119,1903,44,20,54
1877531,1875125,2406,0,2347,59,20,54
1877504,1875545,1959,0,1919,40,20,54
1860096,1859026,1070,71,983,16,20,54
1845865,1844581,1284,10,1260,14,19,53
1814325,1813042,1283,0,1257,26,19,52
1817276,1816287,989,18,939,32,19,50
1807495,1806050,1445,23,1395,27,20,53
1793606,1792256,1350,0,1324,26,20,54
1766485,1764878,1607,0,1563,44,19,54
1779620,1777697,1923,0,1850,73,19,54
1775324,1773653,1671,76,1574,21,17,54
1777172,1775868,1304,0,1267,37,19,54
1779857,1777742,2115,0,2093,22,20,54
1785380,1783371,2009,0,1993,16,20,54
1778695,1777492,1203,0,1142,61,20,53
1763129,1762029,1100,0,1066,34,19,54
1789040,1788144,896,0,891,5,19,52
1790158,1789116,1042,20,994,28,20,54
1778859,1778274,585,0,562,23,20,51
1779109,1777923,1186,68,1076,42,20,54
1794040,1792250,1790,0,1728,62,19,54
1780075,1778061,2014,0,1959,55,18,54
1781620,1779924,1696,50,1601,45,20,54
1782407,1780676,1731,0,1615,116,19,53
1770942,1769214,1728,0,1650,78,20,54
1778674,1776231,2443,0,2343,100,19,54
1767397,1765001,2396,0,2244,152,20,54
1730014,1727423,2591,0,2525,66,19,54
1737482,1736055,1427,0,1383,44,20,54
1719285,1717973,1312,27,1269,16,19,53
1712864,1711894,970,0,928,42,20,52
1693377,1692329,1048,0,991,57,19,54
1693938,1692277,1661,0,1595,66,20,53
1711176,1709244,1932,0,1864,68,20,54
1708025,1705446,2579,0,2534,45,20,54
1706901,1705242,1659,0,1629,30,19,54
1675845,1674070,1775,0,1670,105,20,54
1671182,1669126,2056,26,1942,88,20,54
1686801,1685307,1494,70,1401,23,17,54
1680322,1679346,976,0,950,26,20,53
1671498,1670705,793,0,782,11,20,53
1680136,1678498,1638,18,1609,11,20,54
1692878,1692018,860,0,800,60,20,54
1692925,1691671,1254,0,1200,54,20,54
1698400,1697374,1026,0,986,40,20,53
1706010,1704704,1306,0,1243,63,20,54
1713974,1713251,723,0,696,27,20,51
1686033,1684926,1107,0,1073,34,20,54
1693596,1691095,2501,0,2396,105,20,54
1715852,1714060,1792,0,1693,99,20,54
1691411,1689564,1847,0,1816,31,19,54
1678216,1677003,1213,44,1129,40,18,53
1690207,1688426,1781,0,1702,79,20,54
1704533,1703125,1408,0,1354,54,19,54
1700311,1699149,1162,0,1129,33,20,54
1689070,1687806,1264,0,1187,77,19,54
1679363,1677974,1389,15,1332,42,20,54
1687423,1685850,1573,0,1496,77,20,54
1674353,1672804,1549,0,1486,63,20,54
1674504,1672903,1601,0,1535,66,19,54
1666606,1664559,2047,0,1966,81,20,54
1659229,1656196,3033,0,2880,153,19,54
1650227,1648726,1501,0,1493,8,19,52
1637632,1635998,1634,0,1546,88,19,54
1617472,1616248,1224,0,1150,74,19,54
1633482,1632448,1034,0,948,86,19,53
1635996,1634225,1771,24,1718,29,20,54
1641179,1638891,2288,0,2246,42,19,54
1616466,1613635,2831,75,2718,38,20,54
1623005,1620730,2275,168,2035,72,20,54
1637495,1634435,3060,0,2993,67,19,54
1637857,1636253,1604,0,1546,58,19,54
1622382,1621392,990,5,955,30,19,53
1639435,1638119,1316,0,1296,20,19,54
1612940,1611582,1358,0,1287,71,19,54
1591858,1590097,1761,0,1714,47,20,54
1591829,1590160,1669,0,1654,15,19,54
1598801,1597836,965,0,890,75,19,54
1602546,1601170,1376,89,1230,57,20,54
1622463,1620115,2348,0,2298,50,19,54
1637393,1635908,1485,0,1360,125,20,54
1637577,1636043,1534,0,1466,68,19,54
1633372,1631635,1737,0,1712,25,20,54
1619496,1618382,1114,24,1025,65,19,52
1596040,1594876,1164,0,1117,47,20,54
1585822,1584555,1267,0,1190,77,20,54
1598160,1596954,1206,0,1180,26,20,53
1573219,1570071,3148,86,3034,28,20,54
1551466,1550336,1130,0,1069,61,19,54
1542202,1541039,1163,0,1127,36,18,52
1567883,1567130,753,0,734,19,20,52
1564567,1563005,1562,0,1499,63,20,54
1534772,1533527,1245,0,1212,33,20,53
1510018,1508298,1720,0,1664,56,19,54
1491502,1490333,1169,0,1112,57,20,54
1517676,1515955,1721,0,1677,44,20,54
1525313,1523686,1627,0,1538,89,19,54
1506886,1505656,1230,0,1160,70,19,54
1489147,1487435,1712,0,1686,26,19,54
1487562,1485638,1924,0,1912,12,19,54
1485262,1484554,708,0,696,12,20,52
1492128,1490359,1769,0,1720,49,19,54
1489207,1487732,1475,0,1392,83,20,54
1491388,1490830,558,0,538,20,18,51
1500150,1498494,1656,0,1538,118,19,54
1496999,1495967,1032,0,974,58,19,53
1511052,1510060,992,0,957,35,20,52
1518122,1517199,923,0,840,83,20,53
1512854,1511502,1352,0,1309,43,20,54
1509951,1508441,1510,0,1465,45,19,54
1530051,1528056,1995,0,1938,57,20,54
1542641,1541526,1115,0,1093,22,19,54
1519864,1518488,1376,30,1290,56,20,54
1516833,1514876,1957,72,1817,68,20,54
1541779,1540626,1153,0,1132,21,19,52
1549867,1547754,2113,0,2059,54,20,54
1548907,1547328,1579,0,1462,117,19,54
1528105,1526459,1646,0,1553,93,19,54
1537192,1536187,1005,0,955,50,19,52
1521616,1519955,1661,0,1569,92,20,54
1529173,1528022,1151,0,1097,54,19,54
1519214,1518006,1208,40,1159,9,20,51
1514388,1513175,1213,0,1190,23,20,54
1509473,1508527,946,0,937,9,19,54
1508105,1507054,1051,0,1000,51,18,53
1487282,1485565,1717,0,1632,85,19,54
1481873,1480592,1281,0,1181,100,20,54
1485864,1484083,1781,35,1654,92,20,53
1481575,1480152,1423,0,1373,50,20,54
1458659,1457632,1027,40,938,49,18,54
1452873,1451474,1399,23,1324,52,20,53
1462611,1461609,1002,10,985,7,17,50
1461194,1460278,916,0,903,13,18,50
1469672,1468599,1073,0,1008,65,19,54
1413113,1411630,1483,0,1439,44,20,54
1434951,1433282,1669,0,1599,70,20,51
1428435,1426963,1472,0,1379,93,20,54
1455824,1454337,1487,0,1409,78,19,54
1473132,1471734,1398,21,1354,23,19,52
1499287,1497840,1447,0,1434,13,19,53
1475620,1473809,1811,0,1776,35,19,54
1463786,1461484,2302,0,2242,60,19,54
1455226,1451074,4152,0,3946,206,20,54
1474141,1471770,2371,0,2245,126,20,54
1427598,1425738,1860,0,1822,38,19,54
1455676,1454776,900,0,871,29,19,53
1457820,1456510,1310,0,1242,68,20,54
1472752,1470319,2433,0,2284,149,19,54
1488247,1485597,2650,0,2604,46,19,54
1501764,1499414,2350,0,2210,140,19,54
1496768,1494786,1982,0,1903,79,20,54
1525360,1524548,812,0,807,5,18,45
1515334,1514062,1272,0,1241,31,20,54
1500633,1499328,1305,0,1252,53,20,54
1506467,1504200,2267,0,2200,67,20,54
1499551,1497924,1627,0,1523,104,19,54
1490144,1488840,1304,0,1257,47,19,54
1493874,1492406,1468,80,1366,22,20,54
1514142,1512358,1784,0,1705,79,20,54
1513927,1512532,1395,0,1328,67,20,53
1521646,1520325,1321,0,1253,68,19,54
1506098,1504479,1619,0,1517,102,20,54
1508953,1507586,1367,0,1279,88,19,54
1514260,1512786,1474,0,1414,60,20,54
1510063,1508681,1382,0,1324,58,20,53
1524575,1523741,834,0,783,51,19,54
1520366,1518751,1615,0,1571,44,20,52
1533563,1532192,1371,0,1313,58,20,53
1534219,1532151,2068,0,1970,98,19,54
1548283,1544923,3360,53,3251,56,20,54
1550642,1548643,1999,0,1925,74,19,54
1563392,1562018,1374,0,1333,41,20,54
1570631,1569881,750,0,677,73,19,52
1601924,1600699,1225,0,1178,47,20,54
1598767,1597949,818,0,783,35,20,53
1593464,1593039,425,9,382,34,20,46
1584141,1583631,510,0,488,22,20,48
1576930,1575874,1056,0,1018,38,20,50
1583736,1582834,902,0,868,34,20,52
1598980,1598168,812,0,801,11,19,54
1588781,1588074,707,0,675,32,19,49
1597475,1597280,195,0,192,3,18,35
1609649,1609228,421,0,390,31,16,45
1615925,1615296,629,0,594,35,17,49
1614223,1613619,604,14,586,4,20,52
1609885,1609633,252,0,249,3,17,42
1602251,1602082,169,0,142,27,17,32
1608471,1607929,542,0,526,16,19,48
1609656,1609269,387,0,370,17,18,41
1605994,1605666,328,0,326,2,20,46
1591001,1589994,1007,0,956,51,19,52
1592301,1590855,1446,0,1381,65,20,53
1589699,1588044,1655,0,1555,100,19,54
1598000,1596841,1159,0,1136,23,19,54
1601786,1600987,799,0,773,26,20,52
1586803,1585865,938,33,872,33,20,52
1582669,1581319,1350,0,1318,32,18,52
1579789,1577874,1915,0,1832,83,20,54
1574763,1573159,1604,0,1587,17,18,54
1578513,1576391,2122,0,2067,55,19,54
1573660,1572037,1623,0,1607,16,20,54
1585835,1584219,1616,0,1530,86,19,54
1573840,1572187,1653,55,1565,33,20,54
1567282,1566402,880,59,805,16,18,54
1562369,1561032,1337,34,1245,58,20,54
1595688,1594593,1095,0,1073,22,19,54
1582946,1581860,1086,33,1034,19,20,54
1580138,1578794,1344,0,1289,55,20,54
1571621,1569711,1910,0,1833,77,19,54
1584788,1583269,1519,0,1500,19,19,54
1576265,1574692,1573,0,1509,64,19,54
1577502,1575324,2178,0,2031,147,20,54
1570238,1568671,1567,13,1517,37,20,54
1561498,1559944,1554,0,1481,73,19,54
1576862,1575671,1191,68,1067,56,18,54
1586039,1584804,1235,14,1179,42,20,54
1581280,1580179,1101,0,1062,39,20,54
1574529,1573401,1128,0,1098,30,19,54
1564432,1563617,815,0,789,26,19,51
1567515,1566012,1503,0,1467,36,20,54
1563805,1562735,1070,0,1034,36,20,53
1542781,1541668,1113,0,1026,87,19,54
1544955,1543140,1815,0,1788,27,19,53
1558360,1556805,1555,0,1534,21,20,54
1560751,1558755,1996,0,1947,49,19,54
1544272,1542420,1852,0,1762,90,19,54
1547173,1545445,1728,41,1653,34,20,53
1555770,1554984,786,0,746,40,20,52
1570937,1570141,796,0,760,36,20,53
1569519,1568215,1304,0,1275,29,18,54
1558694,1557122,1572,13,1498,61,19,54
1568717,1567198,1519,0,1480,39,20,54
1574588,1573108,1480,0,1418,62,20,53
1559478,1558354,1124,0,1066,58,18,53
1544756,1543365,1391,0,1358,33,19,54
1542971,1541833,1138,0,1088,50,20,54
1559897,1558573,1324,37,1249,38,19,53
1565406,1563786,1620,0,1511,109,20,54
1570349,1569075,1274,0,1219,55,20,54
1570801,1569191,1610,66,1521,23,20,54
1578808,1577369,1439,0,1390,49,19,54
1584036,1582755,1281,0,1239,42,20,54
1579453,1577818,1635,0,1542,93,20,54
1588249,1586828,1421,0,1400,21,19,54
1570232,1568428,1804,21,1704,79,20,54
1563795,1562367,1428,84,1324,20,18,52
1563658,1562382,1276,124,1134,18,20,54
1577197,1575621,1576,0,1548,28,18,54
1570402,1568605,1797,19,1723,55,20,53
1558027,1556720,1307,0,1232,75,19,53
1555367,1553624,1743,0,1637,106,20,54
1551698,1550292,1406,0,1358,48,20,54
1568575,1566812,1763,0,1693,70,20,54
1566673,1564974,1699,0,1674,25,20,54
1547557,1546629,928,0,874,54,20,53
1553336,1552400,936,29,874,33,19,53
1550169,1548523,1646,0,1533,113,20,54
1537272,1536001,1271,0,1227,44,19,54
1528919,1527469,1450,14,1362,74,19,54
1536546,1535266,1280,0,1234,46,19,54
1543013,1541809,1204,9,1149,46,19,54
1543434,1542406,1028,0,1011,17,19,53
1541561,1540179,1382,0,1308,74,20,53
1558459,1557290,1169,0,1138,31,20,53
1563664,1562446,1218,0,1170,48,19,54
1550243,1547769,2474,0,2376,98,20,54
1548088,1546601,1487,95,1321,71,20,54
1547125,1545888,1237,0,1210,27,20,52
1556240,1554589,1651,0,1613,38,19,54
1537920,1536867,1053,0,1029,24,19,52
1551030,1549547,1483,0,1443,40,20,54
1572432,1570458,1974,76,1883,15,20,54
1602631,1600764,1867,0,1772,95,20,54
1625899,1623712,2187,0,2091,96,20,54
1643507,1640993,2514,0,2472,42,19,54
1647254,1645632,1622,0,1559,63,19,53
1643688,1641228,2460,0,2411,49,19,54
1647636,1645827,1809,0,1740,69,19,54
1650301,1648085,2216,0,2114,102,20,54
1646285,1644706,1579,0,1549,30,19,54
1639948,1638454,1494,0,1434,60,19,53
1641519,1639999,1520,14,1445,61,20,54
1648329,1647157,1172,0,1084,88,20,54
1653783,1652008,1775,0,1726,49,19,54
1656149,1653934,2215,0,2181,34,19,53
1649005,1647560,1445,0,1364,81,19,54
1639812,1638600,1212,0,1114,98,18,53
1649943,1648759,1184,0,1172,12,20,53
1648464,1647019,1445,0,1368,77,20,54
1655447,1654288,1159,0,1122,37,20,54
1624395,1623480,915,0,851,64,20,53
1617644,1616977,667,0,639,28,20,54
1645453,1644892,561,0,548,13,19,49
1660680,1659787,893,0,853,40,20,51
1653990,1652889,1101,0,1055,46,20,54
1649624,1648533,1091,0,1071,20,20,54
1637879,1636467,1412,0,1371,41,19,54
1637085,1635111,1974,0,1923,51,19,54
1633377,1631244,2133,0,2021,112,20,54
1617663,1616224,1439,0,1356,83,19,54
1629621,1628092,1529,52,1452,25,20,53
1608540,1606858,1682,0,1661,21,20,54
1613808,1612816,992,0,955,37,19,54
1623045,1622020,1025,0,1022,3,19,54
1623526,1622484,1042,0,1015,27,18,52
1594451,1592752,1699,0,1651,48,19,52
1594973,1593140,1833,75,1658,100,20,54
1610684,1609054,1630,0,1560,70,19,54
1616083,1614894,1189,0,1126,63,19,53
1596836,1594126,2710,0,2595,115,20,54
1570897,1569366,1531,92,1337,102,20,54
1560001,1558419,1582,0,1497,85,19,53
1551449,1549875,1574,0,1501,73,20,54
1533845,1532545,1300,0,1281,19,19,53
1500082,1497518,2564,0,2466,98,20,54
1478209,1476412,1797,0,1763,34,19,54
1482622,1480163,2459,0,2378,81,20,54
1462032,1459166,2866,0,2761,105,19,54
1481044,1478262,2782,0,2711,71,20,54
1490595,1488521,2074,0,2007,67,20,54
1479693,1478064,1629,0,1581,48,20,54
1481433,1479149,2284,95,2126,63,20,54
1464896,1462559,2337,0,2248,89,19,54
1459769,1457959,1810,48,1684,78,20,54
1461356,1459965,1391,0,1296,95,19,54
1441694,1439924,1770,0,1726,44,20,53
1444727,1443456,1271,0,1200,71,20,54
1448641,1447442,1199,40,1125,34,17,52
1428542,1427570,972,45,886,41,20,54
1416833,1415566,1267,0,1209,58,19,54
1418395,1417642,753,0,729,24,20,50
1406615,1405621,994,0,957,37,19,54
1388899,1387680,1219,0,1176,43,20,52
1395233,1394513,720,0,707,13,20,51
1405884,1405170,714,26,667,21,20,52
1397203,1396145,1058,0,1017,41,18,52
1389334,1387785,1549,0,1461,88,20,53
1390534,1389233,1301,0,1282,19,20,54
1366367,1365236,1131,0,1065,66,19,54
1377134,1376586,548,0,539,9,20,53
1384731,1384198,533,0,523,10,19,51
1379980,1378932,1048,32,965,51,20,54
1379323,1378113,1210,0,1180,30,19,54
1377539,1375812,1727,0,1618,109,20,54
1378528,1376485,2043,60,1916,67,20,54
1373211,1371913,1298,78,1190,30,18,48
1346039,1344631,1408,0,1338,70,19,54
1348250,1347164,1086,0,1040,46,20,51
1379686,1378179,1507,0,1463,44,20,54
1402388,1400959,1429,0,1400,29,20,53
1422193,1421193,1000,0,978,22,20,54
1422886,1421452,1434,0,1364,70,19,54
1438414,1436540,1874,0,1838,36,19,54
1497643,1495531,2112,0,2043,69,19,53
1542371,1539615,2756,47,2557,152,20,54
1580348,1577749,2599,0,2463,136,19,54
1582193,1579430,2763,0,2631,132,19,54
1625434,1623369,2065,0,2002,63,19,52
1658715,1657054,1661,0,1592,69,20,54
1676410,1674832,1578,0,1516,62,19,52
1677635,1675858,1777,25,1701,51,20,54
1688043,1686370,1673,0,1655,18,20,54
1722517,1720110,2407,0,2301,106,20,53
1750800,1748290,2510,217,2236,57,20,54
1784419,1782797,1622,0,1580,42,19,54
1817885,1816736,1149,0,1095,54,20,52
1942230,1940956,1274,0,1218,56,19,53
1967588,1964779,2809,0,2666,143,20,54
2011015,2007551,3464,0,3381,83,20,54
2065575,2063889,1686,100,1508,78,20,54
2096433,2094628,1805,0,1734,71,18,52
2137883,2136072,1811,0,1751,60,20,53
2185115,2181523,3592,0,3480,112,20,54
2230935,2227493,3442,0,3336,106,19,54
2259393,2254756,4637,0,4514,123,19,54
2284649,2281814,2835,125,2651,59,20,54
2346913,2343480,3433,0,3276,157,20,54
2424980,2421449,3531,0,3348,183,19,54
2456647,2454200,2447,135,2237,75,20,54
2445741,2443319,2422,0,2325,97,19,53
2482294,2478951,3343,0,3292,51,20,54
2525764,2522853,2911,0,2821,90,20,54
2642043,2640045,1998,0,1960,38,18,53
2671884,2669754,2130,0,2056,74,20,53
2699028,2696304,2724,0,2689,35,18,54
2757131,2754853,2278,0,2247,31,19,54
2778192,2775270,2922,0,2829,93,20,54
2774845,2770454,4391,0,4335,56,19,54
2757648,2754507,3141,0,3058,83,20,54
2748854,2745143,3711,0,3647,64,19,54
2702624,2700782,1842,0,1702,140,19,52
2658145,2654586,3559,0,3403,156,20,53
2650438,2646920,3518,189,3216,113,20,54
2615459,2611848,3611,0,3527,84,20,54
2574937,2571729,3208,0,3116,92,20,54
2575486,2571975,3511,220,3250,41,20,54
2516220,2512967,3253,82,3094,77,20,54
2480349,2476625,3724,0,3658,66,19,54
2458805,2455735,3070,0,2985,85,19,53
2426576,2424334,2242,0,2209,33,20,54
3670140,3666881,3259,0,3186,73,19,47
3640957,3636970,3987,0,3893,94,18,54
3547316,3543753,3563,0,3437,126,20,54
3823203,3819346,3857,0,3790,67,18,54
3861981,3857461,4520,0,4424,96,19,54
3807327,3802000,5327,0,5167,160,19,54
3808420,3803125,5295,0,5114,181,19,54
3746630,3740072,6558,0,6243,315,20,54
3797264,3793106,4158,0,3989,169,19,54
3830975,3826833,4142,0,4028,114,20,54
3879648,3873750,5898,427,5247,224,20,54
3903327,3898184,5143,0,5020,123,20,54
3894342,3888598,5744,0,5527,217,20,54
3932688,3927220,5468,0,5261,207,20,54
3901928,3895806,6122,0,5788,334,20,54
3933070,3928690,4380,0,4177,203,20,53
4033223,4028137,5086,362,4519,205,18,54
4049369,4043846,5523,0,5406,117,19,54
4042652,4037477,5175,347,4660,168,20,54
4112526,4107523,5003,0,4720,283,19,54
4143728,4132382,11346,0,10879,467,20,54
4132658,4113314,19344,0,18815,529,20,54
4122215,4104461,17754,0,17180,574,19,54
4157872,4148250,9622,0,9296,326,20,54
4230342,4221042,9300,0,9058,242,19,54
4239951,4233560,6391,0,6049,342,19,54
