coverage,wt.counts,mut.count,s.count,ns.count,stp.count,aa.sampled,codons.sampled
2829146,2823644,5502,0,5353,149,19,54
2846422,2842795,3627,0,3580,47,20,54
2842528,2838688,3840,0,3823,17,20,54
2824576,2819869,4707,0,4554,153,19,53
2786115,2780983,5132,0,5021,111,20,54
2831715,2825098,6617,188,6314,115,20,54
2847691,2841882,5809,0,5692,117,19,54
2849337,2841185,8152,0,7888,264,19,54
2825597,2820487,5110,0,5066,44,18,54
2861005,2856654,4351,0,4102,249,20,54
2839502,2835401,4101,0,3992,109,19,54
2872420,2868650,3770,0,3730,40,20,53
2632650,2627538,5112,0,5001,111,19,54
2583428,2580224,3204,0,3149,55,19,51
2554550,2547838,6712,0,6606,106,20,53
2553976,2550552,3424,279,3056,89,18,53
2497872,2495798,2074,42,2014,18,19,42
1536816,1534917,1899,0,1867,32,19,54
1586701,1584428,2273,0,2216,57,20,54
1620907,1619426,1481,96,1342,43,20,53
1655633,1654344,1289,0,1282,7,20,53
1667078,1666306,772,0,712,60,19,52
1703716,1703074,642,7,593,42,20,46
1731433,1728991,2442,0,2383,59,19,53
1756589,1754395,2194,0,2146,48,19,53
1776112,1773930,2182,0,2163,19,18,52
1821759,1818900,2859,0,2831,28,20,54
1811451,1808797,2654,0,2579,75,20,54
1826672,1824080,2592,0,2498,94,19,54
1819767,1817098,2669,0,2555,114,19,54
1811982,1809504,2478,0,2402,76,19,54
1746913,1745055,1858,0,1818,40,20,54
1753402,1751736,1666,0,1645,21,20,53
1738955,1737105,1850,0,1834,16,18,53
1765714,1763595,2119,0,2081,38,19,53
1781765,1780529,1236,0,1206,30,20,53
1724165,1722802,1363,0,1326,37,20,54
1714179,1712718,1461,21,1390,50,20,54
1733481,1731202,2279,0,2215,64,18,53
1719041,1716396,2645,26,2558,61,20,54
1721539,1719849,1690,0,1650,40,20,54
1726691,1725879,812,0,787,25,19,53
1728552,1727122,1430,13,1394,23,19,54
1706580,1705044,1536,0,1491,45,19,54
1698738,1696724,2014,0,1984,30,19,53
1690926,1687133,3793,0,3713,80,20,54
1698996,1696327,2669,0,2611,58,20,54
1664421,1661549,2872,0,2823,49,19,54
1663407,1661699,1708,0,1584,124,18,52
1646873,1645633,1240,0,1208,32,20,52
1647640,1646296,1344,0,1298,46,20,52
1622388,1619937,2451,0,2419,32,18,54
1627376,1624800,2576,0,2398,178,20,54
1598059,1596453,1606,0,1467,139,20,53
1578928,1576739,2189,0,2178,11,19,52
1568032,1566227,1805,0,1736,69,20,51
1558211,1556976,1235,0,1201,34,19,52
1552109,1550344,1765,0,1748,17,17,49
1530986,1529270,1716,0,1665,51,19,53
1502583,1500579,2004,0,1861,143,19,54
1514518,1511644,2874,0,2769,105,19,54
1488226,1486664,1562,0,1513,49,19,54
1471214,1470350,864,0,825,39,19,45
1451087,1449054,2033,38,1969,26,20,54
1414316,1411589,2727,38,2623,66,20,54
1396858,1395221,1637,0,1607,30,20,54
1392071,1390376,1695,0,1613,82,20,54
1393834,1391568,2266,59,2102,105,20,53
1370164,1367687,2477,0,2323,154,19,54
1362560,1360634,1926,30,1835,61,20,54
1369461,1368069,1392,0,1278,114,20,52
1378817,1377513,1304,0,1249,55,20,51
1373424,1373090,334,0,315,19,19,39
1346718,1344961,1757,0,1703,54,19,54
1340191,1339044,1147,0,1125,22,19,54
1331172,1329173,1999,0,1939,60,19,54
1327968,1325838,2130,0,2101,29,20,54
1312809,1310492,2317,0,2293,24,20,54
1284812,1282110,2702,150,2445,107,20,54
1268613,1266519,2094,0,2005,89,19,54
1256704,1254380,2324,238,2045,41,18,53
1244552,1243020,1532,0,1507,25,20,53
1251275,1249135,2140,156,1948,36,20,54
1256980,1255006,1974,78,1881,15,20,54
1258388,1256210,2178,0,2116,62,18,53
1264640,1261605,3035,0,2923,112,20,54
1270477,1268524,1953,78,1864,11,19,54
1272991,1270817,2174,0,2123,51,20,54
1278852,1277752,1100,0,1076,24,17,52
1273824,1272307,1517,59,1396,62,20,54
1270072,1268645,1427,0,1390,37,20,54
1281655,1280129,1526,0,1497,29,19,54
1283578,1281663,1915,0,1868,47,19,52
1286450,1284866,1584,0,1535,49,20,52
1285595,1283774,1821,0,1787,34,19,54
1282705,1280307,2398,0,2366,32,19,54
1285132,1283597,1535,0,1502,33,19,54
1294725,1293887,838,0,802,36,19,50
1289080,1287940,1140,0,1040,100,19,54
1271224,1269924,1300,0,1216,84,19,52
1267401,1265785,1616,0,1556,60,19,54
1259821,1258091,1730,0,1672,58,19,53
1249327,1248185,1142,0,1101,41,20,52
1236809,1234632,2177,0,2162,15,20,54
1221795,1219593,2202,0,2147,55,20,54
1210618,1209215,1403,0,1383,20,20,54
1234481,1233357,1124,0,1118,6,19,53
1225062,1223408,1654,0,1619,35,20,53
1218878,1217602,1276,0,1243,33,19,54
1224720,1223181,1539,0,1521,18,20,54
1229231,1227634,1597,22,1532,43,20,54
1216778,1215121,1657,0,1620,37,17,53
1209988,1207921,2067,0,2000,67,19,52
1232125,1230913,1212,89,1089,34,20,51
1242818,1241457,1361,0,1303,58,19,54
1244014,1242436,1578,0,1559,19,20,54
1255525,1253922,1603,0,1565,38,20,53
1264372,1262903,1469,0,1450,19,20,54
1277299,1275947,1352,0,1345,7,19,54
1296001,1294488,1513,0,1460,53,19,54
1299145,1296988,2157,0,2135,22,19,54
1300411,1298724,1687,0,1638,49,20,54
1298155,1296507,1648,0,1596,52,20,54
1315489,1313650,1839,0,1784,55,19,54
1311404,1309873,1531,0,1466,65,20,54
1313481,1312306,1175,0,1125,50,18,52
1321409,1319106,2303,0,2151,152,20,54
1336115,1334464,1651,0,1557,94,20,54
1333421,1332077,1344,0,1295,49,20,54
1329302,1327372,1930,0,1865,65,19,54
1326919,1325488,1431,104,1264,63,17,53
1330963,1329644,1319,0,1255,64,20,53
1320546,1318950,1596,0,1588,8,20,54
1318848,1317567,1281,0,1243,38,20,52
1308030,1306416,1614,50,1532,32,20,52
1295802,1294497,1305,0,1274,31,19,53
1298389,1297323,1066,9,1031,26,20,52
1298180,1296453,1727,0,1688,39,19,53
1303895,1302743,1152,0,1127,25,19,52
1307809,1306965,844,0,836,8,19,51
1310596,1309655,941,0,918,23,19,51
1304962,1303868,1094,0,1086,8,19,53
1303497,1302786,711,0,694,17,20,51
1326501,1325238,1263,36,1217,10,20,54
1333846,1332784,1062,0,1047,15,20,54
1331989,1331341,648,0,632,16,20,51
1326401,1326118,283,0,271,12,18,37
1328693,1327543,1150,0,1114,36,19,53
1312201,1310335,1866,0,1853,13,19,54
1305608,1304146,1462,0,1450,12,18,53
1297606,1296095,1511,5,1432,74,19,54
1289190,1288362,828,0,798,30,20,52
1268707,1267479,1228,0,1202,26,19,51
1261490,1259632,1858,0,1778,80,20,54
1277858,1276390,1468,73,1342,53,17,54
1264182,1262825,1357,22,1315,20,19,52
1249448,1248153,1295,0,1248,47,19,54
1230678,1229035,1643,83,1535,25,18,53
1222445,1220864,1581,0,1573,8,20,51
1213553,1212402,1151,6,1079,66,19,53
1222971,1221628,1343,0,1294,49,20,54
1225868,1224258,1610,0,1578,32,19,53
1212750,1211085,1665,0,1663,2,19,53
1203872,1202645,1227,0,1194,33,18,50
1202097,1200447,1650,0,1578,72,18,51
1216947,1215168,1779,0,1752,27,19,54
1218701,1216544,2157,0,2114,43,20,54
1193322,1192286,1036,0,1007,29,19,51
1198206,1196327,1879,0,1863,16,20,53
1185666,1183369,2297,70,2192,35,19,54
1186532,1185246,1286,0,1255,31,20,54
1180382,1178768,1614,35,1556,23,20,52
1175665,1174440,1225,0,1167,58,20,54
1172151,1170150,2001,0,1972,29,19,54
1195636,1194719,917,0,902,15,20,53
1201697,1200172,1525,0,1425,100,20,54
1193997,1192323,1674,0,1622,52,20,54
1192472,1191047,1425,0,1380,45,19,54
1195547,1194465,1082,0,1041,41,19,51
1199779,1198842,937,0,920,17,19,52
1193127,1192097,1030,0,1016,14,19,53
1189425,1188709,716,0,694,22,19,53
1179773,1178797,976,0,946,30,20,53
1177394,1176529,865,14,820,31,20,53
1181621,1180765,856,0,806,50,17,53
1188600,1187566,1034,0,999,35,20,54
1192757,1192014,743,0,719,24,19,53
1189431,1188767,664,0,653,11,19,50
1172932,1171489,1443,0,1431,12,20,53
1173889,1172329,1560,0,1520,40,19,53
1195642,1193761,1881,97,1764,20,17,53
1191797,1190318,1479,10,1431,38,20,54
1179042,1177215,1827,0,1795,32,20,53
1158450,1156965,1485,0,1389,96,19,54
1167953,1166798,1155,0,1133,22,19,54
1177978,1176891,1087,0,1010,77,20,52
1164695,1162856,1839,0,1726,113,20,54
1153524,1151123,2401,0,2338,63,19,54
1149376,1148263,1113,0,1088,25,20,52
1147172,1145579,1593,0,1543,50,19,54
1141385,1140353,1032,0,996,36,19,54
1148570,1147491,1079,0,1014,65,20,54
1156966,1156193,773,0,718,55,19,53
1148429,1147663,766,0,734,32,20,53
1137350,1136397,953,0,937,16,19,52
1140309,1138080,2229,15,2127,87,20,53
1164367,1163542,825,0,788,37,19,52
1150689,1149400,1289,0,1255,34,18,53
1170231,1169150,1081,0,1058,23,20,53
1170604,1169914,690,0,668,22,20,49
1178345,1177101,1244,48,1154,42,19,53
1186230,1184038,2192,198,1934,60,20,54
1176070,1174238,1832,0,1788,44,20,54
1167181,1165611,1570,0,1533,37,19,53
1160233,1159550,683,39,634,10,17,45
1150853,1149885,968,0,934,34,19,51
1145608,1144830,778,0,771,7,19,52
1128572,1127539,1033,0,1002,31,20,54
1143812,1143005,807,0,778,29,19,50
1146576,1145452,1124,79,999,46,20,53
1135134,1133569,1565,0,1507,58,20,53
1126746,1125938,808,0,792,16,18,53
1121300,1121075,225,0,213,12,16,32
1135919,1134746,1173,0,1080,93,20,54
1141504,1140406,1098,0,1081,17,20,53
1134803,1133779,1024,0,996,28,19,51
1123178,1122605,573,0,547,26,18,48
1124848,1124175,673,0,653,20,20,50
1128503,1127033,1470,0,1417,53,20,54
1137253,1136451,802,0,777,25,19,50
1141045,1139801,1244,41,1158,45,20,53
1141495,1140358,1137,0,1103,34,19,54
1155902,1154450,1452,12,1366,74,20,53
1147698,1146311,1387,0,1292,95,18,53
1134266,1133401,865,0,834,31,18,51
1142491,1140168,2323,92,2195,36,17,54
1148407,1146871,1536,0,1487,49,20,53
1147757,1146580,1177,0,1162,15,19,54
1134310,1132946,1364,65,1270,29,18,54
1129399,1128123,1276,0,1241,35,19,54
1136662,1135111,1551,0,1512,39,19,54
1132190,1130404,1786,0,1771,15,20,54
1125077,1123186,1891,0,1832,59,19,54
1120117,1117498,2619,0,2550,69,20,54
1124469,1122656,1813,0,1786,27,20,54
1114368,1112722,1646,0,1560,86,19,54
1113901,1112651,1250,0,1208,42,19,54
1092086,1090479,1607,0,1564,43,19,54
1084445,1082329,2116,0,2072,44,20,54
1083917,1081802,2115,0,2048,67,20,54
1080546,1079322,1224,0,1206,18,20,54
1077318,1076812,506,0,486,20,16,43
1074188,1072454,1734,50,1616,68,20,53
1083011,1082157,854,0,813,41,20,51
1097132,1096257,875,0,858,17,18,52
1106580,1105882,698,0,648,50,20,51
1114259,1113121,1138,0,1127,11,20,52
1103747,1102586,1161,0,1093,68,19,54
1111587,1109648,1939,0,1880,59,19,53
1117980,1116492,1488,0,1451,37,19,54
1113560,1111864,1696,0,1649,47,19,54
1127942,1126114,1828,0,1746,82,18,53
1133918,1132440,1478,37,1376,65,20,53
1136388,1135251,1137,32,1078,27,20,52
1145890,1144785,1105,0,1062,43,19,50
1146371,1145421,950,0,902,48,17,50
1149041,1147967,1074,0,1052,22,19,54
1150404,1148496,1908,180,1685,43,20,54
1153401,1151604,1797,0,1747,50,20,53
1154290,1152516,1774,0,1678,96,20,54
1145473,1144692,781,0,758,23,19,51
1146392,1145037,1355,0,1318,37,19,54
1154189,1153219,970,0,941,29,19,53
1161603,1160520,1083,0,1065,18,20,51
1167639,1166269,1370,0,1354,16,20,53
1154936,1154297,639,0,594,45,19,51
1155036,1154165,871,0,828,43,19,54
1166987,1165852,1135,97,982,56,20,53
1169184,1168333,851,0,842,9,20,51
1165152,1164071,1081,0,1067,14,18,49
1168014,1166695,1319,0,1233,86,19,53
1168887,1167821,1066,0,1039,27,19,53
1167466,1166528,938,0,880,58,19,52
1157637,1156562,1075,0,1002,73,19,50
1167707,1166564,1143,0,1107,36,20,54
1168900,1167840,1060,59,972,29,18,50
1178946,1178060,886,0,847,39,18,47
1184578,1182794,1784,0,1710,74,19,54
1186392,1185399,993,0,940,53,18,52
1187690,1186297,1393,0,1364,29,20,52
1202057,1200669,1388,0,1340,48,19,52
1209309,1208238,1071,11,1008,52,20,54
1218098,1217041,1057,0,1010,47,19,51
1217984,1216010,1974,0,1851,123,20,54
1210942,1209907,1035,0,975,60,19,53
1205690,1204097,1593,0,1516,77,20,54
1220749,1219640,1109,0,1096,13,20,52
1225868,1223982,1886,0,1807,79,20,54
1233797,1232192,1605,0,1516,89,20,54
1222718,1220723,1995,12,1898,85,20,54
1225600,1223801,1799,0,1736,63,19,54
1221007,1217802,3205,0,3159,46,20,54
1231993,1229606,2387,0,2373,14,19,54
1226447,1224923,1524,0,1480,44,20,54
1234474,1232836,1638,0,1610,28,19,53
1237480,1235871,1609,55,1509,45,20,53
1244569,1242795,1774,0,1731,43,20,53
1243266,1241751,1515,0,1467,48,19,54
1248931,1247087,1844,0,1821,23,19,53
1256327,1253869,2458,0,2415,43,20,54
1252440,1250754,1686,0,1648,38,20,53
1260043,1259103,940,0,886,54,19,50
1256546,1253596,2950,0,2837,113,19,54
1259446,1256604,2842,0,2759,83,20,54
1265288,1263143,2145,0,2076,69,19,54
1260279,1258364,1915,0,1866,49,19,53
1254205,1252293,1912,0,1880,32,20,54
1245218,1243241,1977,0,1901,76,20,54
1256671,1255061,1610,0,1506,104,18,53
1262099,1260088,2011,0,1991,20,19,54
1261995,1259986,2009,0,1907,102,20,54
1260052,1258659,1393,0,1356,37,19,54
1251877,1250119,1758,0,1721,37,20,54
1230618,1229083,1535,0,1463,72,19,54
1230184,1228151,2033,0,1982,51,19,54
1227537,1225995,1542,67,1459,16,19,53
1238714,1237032,1682,48,1591,43,20,54
1234786,1232087,2699,118,2561,20,19,53
1227820,1226420,1400,0,1359,41,20,52
1218303,1216743,1560,0,1492,68,19,54
1230981,1229354,1627,0,1556,71,19,54
1225500,1223881,1619,0,1590,29,19,54
1219182,1217487,1695,0,1650,45,20,54
1238070,1236036,2034,76,1936,22,19,54
1252655,1249934,2721,0,2671,50,20,54
1245134,1242382,2752,0,2631,121,20,54
1254418,1251968,2450,0,2299,151,19,54
1264786,1262592,2194,0,2087,107,19,54
1275330,1272703,2627,0,2549,78,20,54
1269909,1268354,1555,0,1469,86,20,54
1268783,1267747,1036,0,992,44,19,53
1266716,1265246,1470,155,1296,19,20,51
1275619,1273880,1739,0,1692,47,19,53
1275730,1273325,2405,0,2340,65,19,54
1281486,1279800,1686,0,1609,77,20,54
1279295,1275704,3591,18,3474,99,19,54
1292583,1290846,1737,0,1664,73,20,53
1281137,1280368,769,9,754,6,20,52
1276465,1274890,1575,0,1505,70,19,52
1283173,1281998,1175,0,1160,15,19,52
1301369,1298962,2407,0,2288,119,20,54
1311438,1308482,2956,0,2852,104,19,54
1319134,1317335,1799,32,1753,14,20,54
1323776,1322122,1654,0,1592,62,20,54
1337769,1336259,1510,42,1383,85,20,54
1353464,1351791,1673,0,1578,95,20,54
1372665,1370315,2350,0,2215,135,19,54
1362442,1360691,1751,0,1702,49,20,54
1370805,1368386,2419,0,2379,40,19,54
1361840,1359803,2037,0,1998,39,20,54
1355172,1353117,2055,0,1946,109,19,54
1366603,1364049,2554,0,2390,164,20,54
1378304,1376498,1806,0,1761,45,20,54
1370788,1368707,2081,0,1976,105,20,54
1361565,1359743,1822,0,1791,31,19,51
1359496,1358910,586,0,571,15,19,51
1371640,1371327,313,24,280,9,14,38
1295991,1294796,1195,0,1148,47,19,54
1365816,1363772,2044,0,1988,56,20,54
1358455,1357286,1169,0,1148,21,20,54
1354445,1352977,1468,0,1456,12,18,53
1363779,1362564,1215,0,1182,33,19,53
1355397,1353781,1616,0,1574,42,19,54
1353575,1352055,1520,0,1496,24,19,54
1350532,1348570,1962,55,1872,35,17,54
1359575,1357374,2201,0,2109,92,19,54
1356273,1354832,1441,0,1412,29,19,53
1348475,1347055,1420,0,1370,50,19,54
1338702,1336794,1908,0,1861,47,20,54
1343196,1340669,2527,0,2454,73,19,54
1345328,1343130,2198,0,2174,24,19,53
1341375,1339946,1429,0,1391,38,19,53
1346606,1344826,1780,24,1743,13,19,52
1336021,1334431,1590,0,1522,68,20,53
1346405,1345369,1036,0,1003,33,20,53
1354104,1352882,1222,0,1188,34,20,52
1368975,1367726,1249,0,1232,17,20,53
1373141,1371631,1510,0,1478,32,19,54
1374209,1373036,1173,0,1084,89,19,52
1353625,1350867,2758,0,2662,96,20,54
1360376,1357790,2586,0,2557,29,20,54
1356680,1355404,1276,0,1255,21,19,52
1359006,1357481,1525,0,1513,12,18,54
1357270,1356014,1256,0,1190,66,20,53
1360999,1359291,1708,0,1656,52,19,54
1364606,1362504,2102,25,1929,148,20,54
1374657,1372869,1788,0,1703,85,19,54
1387408,1384377,3031,0,2961,70,19,54
1397494,1395600,1894,0,1826,68,20,54
1403266,1401223,2043,0,2018,25,19,53
1414717,1412987,1730,0,1687,43,19,53
1418435,1416886,1549,0,1478,71,19,53
1413385,1411348,2037,0,1917,120,20,54
1423532,1422439,1093,0,1052,41,19,54
1423949,1422901,1048,46,993,9,20,52
1422927,1422059,868,30,801,37,19,53
1419653,1419131,522,0,499,23,17,44
1412241,1411753,488,0,475,13,17,46
1413265,1411531,1734,0,1713,21,20,54
1430257,1428736,1521,49,1408,64,20,54
1458391,1456349,2042,0,1985,57,20,54
1458148,1455026,3122,0,3036,86,19,54
1453840,1452264,1576,0,1538,38,19,53
1464182,1463217,965,0,918,47,20,50
1436051,1434067,1984,0,1855,129,20,54
1440494,1439141,1353,0,1291,62,20,52
1443722,1441674,2048,0,1990,58,20,54
1449228,1447541,1687,0,1622,65,20,54
1450803,1448743,2060,32,1973,55,19,53
1448960,1447044,1916,0,1871,45,19,53
1441198,1439140,2058,0,2038,20,20,54
1435710,1433534,2176,0,2076,100,19,54
1463869,1460630,3239,0,3176,63,20,54
1468905,1464853,4052,111,3898,43,20,54
1440718,1438387,2331,184,2026,121,20,54
1435465,1432833,2632,0,2588,44,20,54
1433424,1431413,2011,0,1880,131,20,54
1419373,1418057,1316,87,1210,19,20,54
1405726,1404177,1549,21,1480,48,19,52
1383963,1382494,1469,0,1398,71,19,52
1386186,1385006,1180,12,1123,45,19,51
1384784,1382990,1794,24,1692,78,20,54
1368795,1367502,1293,0,1251,42,20,54
1349412,1347777,1635,0,1611,24,19,54
1359195,1357062,2133,0,2053,80,19,54
1355933,1354279,1654,12,1598,44,17,53
1357791,1356551,1240,0,1210,30,19,54
1360220,1357829,2391,0,2333,58,20,53
1365513,1363675,1838,0,1804,34,20,54
1360473,1359136,1337,0,1275,62,20,53
1354122,1352754,1368,0,1294,74,19,54
1369400,1368387,1013,0,997,16,19,54
1370322,1369083,1239,26,1190,23,20,54
1361451,1360829,622,0,609,13,20,51
1364861,1363379,1482,115,1281,86,20,54
1376553,1374694,1859,0,1766,93,19,54
1368291,1366104,2187,0,2149,38,18,54
1368424,1367038,1386,63,1270,53,20,52
1368810,1367075,1735,0,1653,82,19,54
1367140,1365202,1938,0,1792,146,20,54
1366226,1363876,2350,0,2229,121,19,54
1356109,1353746,2363,0,2226,137,20,53
1326882,1324015,2867,0,2797,70,19,54
1333690,1332106,1584,0,1507,77,20,54
1318905,1317484,1421,38,1369,14,19,54
1315591,1314408,1183,0,1156,27,20,54
1304354,1303089,1265,0,1205,60,19,54
1305581,1303514,2067,0,2018,49,20,54
1319616,1317319,2297,0,2194,103,20,54
1315525,1312568,2957,0,2877,80,20,54
1316995,1314966,2029,0,1942,87,19,54
1297212,1295359,1853,0,1761,92,20,54
1290909,1288754,2155,16,2016,123,20,54
1303952,1302296,1656,73,1542,41,17,52
1297344,1296318,1026,0,979,47,20,54
1290141,1289089,1052,0,1052,0,18,52
1296708,1295032,1676,42,1629,5,20,54
1305812,1304886,926,0,883,43,20,52
1307183,1306135,1048,0,971,77,20,54
1312633,1311470,1163,0,1123,40,20,53
1318479,1316990,1489,0,1446,43,20,54
1324681,1323836,845,0,832,13,20,52
1303921,1302896,1025,0,999,26,20,52
1317303,1314385,2918,0,2787,131,20,54
1327084,1325411,1673,0,1573,100,20,54
1311692,1309574,2118,0,2081,37,19,54
1299105,1297765,1340,57,1223,60,18,53
1305083,1303208,1875,0,1760,115,20,54
1315414,1313716,1698,0,1609,89,19,54
1313647,1312366,1281,0,1241,40,20,54
1305288,1303875,1413,0,1342,71,19,54
1296352,1294995,1357,38,1254,65,20,53
1299871,1298394,1477,0,1416,61,20,54
1291483,1290191,1292,0,1220,72,20,54
1290693,1289231,1462,0,1408,54,19,54
1283607,1281461,2146,0,2049,97,20,54
1278148,1275562,2586,0,2461,125,19,53
1265645,1263802,1843,0,1827,16,19,53
1256147,1254163,1984,0,1931,53,19,54
1240030,1238748,1282,0,1250,32,19,53
1252198,1251250,948,0,906,42,19,54
1256073,1254029,2044,24,1929,91,20,54
1259887,1257540,2347,0,2272,75,19,54
1241260,1238462,2798,58,2701,39,20,54
1246859,1244575,2284,155,2001,128,20,54
1254281,1251042,3239,0,3171,68,19,54
1251058,1249655,1403,0,1344,59,19,54
1238705,1237703,1002,16,937,49,19,50
1252884,1251303,1581,0,1536,45,19,53
1234187,1232831,1356,0,1258,98,19,54
1217230,1215404,1826,0,1770,56,20,54
1217786,1216144,1642,0,1638,4,19,54
1222324,1221357,967,0,911,56,19,53
1226209,1224971,1238,119,1075,44,20,54
1241360,1238890,2470,0,2378,92,19,54
1253952,1252403,1549,0,1458,91,20,54
1252673,1251138,1535,0,1473,62,19,54
1254056,1252502,1554,0,1536,18,20,53
1239871,1238843,1028,18,955,55,19,52
1230646,1229422,1224,0,1170,54,20,54
1217251,1215952,1299,0,1236,63,20,54
1227720,1226395,1325,0,1287,38,19,52
1209554,1206504,3050,133,2846,71,20,54
1194306,1193187,1119,0,1101,18,18,51
1187669,1186360,1309,0,1292,17,19,53
1208178,1207595,583,0,562,21,20,52
1205127,1203584,1543,0,1490,53,20,54
1185266,1184058,1208,0,1167,41,20,53
1162956,1161231,1725,0,1676,49,19,54
1152831,1151785,1046,0,1029,17,20,53
1173072,1171496,1576,0,1522,54,20,54
1180262,1178557,1705,0,1631,74,19,54
1167455,1166114,1341,0,1292,49,19,53
1153777,1152034,1743,0,1697,46,19,52
1152416,1150336,2080,0,2067,13,19,53
1149295,1148493,802,0,792,10,20,53
1156345,1154653,1692,0,1675,17,19,54
1156140,1155081,1059,0,1021,38,20,54
1157990,1157389,601,0,565,36,18,51
1166841,1165293,1548,0,1449,99,19,53
1162466,1161190,1276,0,1235,41,19,52
1172564,1171387,1177,0,1118,59,20,54
1178848,1177732,1116,0,1063,53,20,53
1174014,1172470,1544,0,1487,57,20,54
1173412,1171728,1684,0,1651,33,19,54
1187270,1185321,1949,0,1863,86,20,54
1197278,1196052,1226,0,1212,14,19,52
1177853,1176246,1607,89,1473,45,20,54
1174104,1172222,1882,58,1756,68,20,54
1195197,1193911,1286,0,1260,26,19,54
1199446,1197350,2096,0,2061,35,20,54
1198077,1196376,1701,0,1596,105,19,54
1184959,1183240,1719,0,1600,119,19,54
1188655,1187667,988,0,953,35,19,52
1176159,1174872,1287,0,1203,84,20,54
1180101,1178900,1201,0,1167,34,19,53
1172522,1171477,1045,29,976,40,19,46
1168946,1167707,1239,0,1176,63,20,53
1164625,1163639,986,0,981,5,19,53
1165005,1163970,1035,0,966,69,19,53
1144944,1143140,1804,0,1774,30,19,54
1140657,1139555,1102,0,1011,91,20,53
1142157,1140684,1473,30,1358,85,20,53
1137992,1136605,1387,0,1330,57,20,52
1121421,1120434,987,37,909,41,18,52
1119625,1118393,1232,10,1182,40,20,54
1123877,1122755,1122,47,1060,15,17,52
1121833,1120888,945,0,924,21,18,51
1125315,1124271,1044,0,1009,35,19,53
1090902,1089359,1543,0,1456,87,20,54
1096562,1094794,1768,0,1681,87,20,52
1093531,1092200,1331,0,1180,151,20,54
1114566,1112834,1732,0,1621,111,19,54
1127257,1125835,1422,32,1377,13,19,54
1145077,1143620,1457,0,1432,25,19,53
1127415,1125761,1654,0,1619,35,19,54
1114779,1112681,2098,0,2028,70,19,54
1110175,1106273,3902,0,3717,185,20,53
1120151,1117817,2334,0,2176,158,20,54
1100773,1098861,1912,0,1879,33,19,54
1102993,1102182,811,0,785,26,20,49
1106948,1105859,1089,0,1057,32,20,53
1123224,1120827,2397,0,2246,151,19,54
1126255,1123590,2665,0,2568,97,19,54
1134061,1131737,2324,0,2224,100,19,54
1128735,1126641,2094,0,2015,79,20,54
1150351,1149593,758,0,757,1,15,40
1141745,1140692,1053,0,987,66,19,50
1127508,1126204,1304,0,1261,43,20,52
1132787,1130898,1889,0,1843,46,20,54
1131891,1130328,1563,0,1475,88,19,54
1116752,1115390,1362,0,1287,75,19,54
1118725,1117237,1488,52,1405,31,20,54
1132629,1130885,1744,0,1689,55,20,54
1130153,1128844,1309,0,1271,38,20,53
1136624,1135329,1295,0,1229,66,19,54
1125100,1123842,1258,0,1179,79,20,54
1125289,1124487,802,0,729,73,18,51
1128657,1127568,1089,0,1062,27,20,54
1128695,1127545,1150,0,1047,103,20,53
1134553,1133596,957,0,929,28,19,53
1130520,1129069,1451,0,1417,34,20,53
1137775,1136236,1539,0,1496,43,20,54
1139171,1137204,1967,0,1907,60,19,54
1149508,1146575,2933,66,2807,60,20,54
1149550,1147896,1654,0,1606,48,19,54
1158706,1157392,1314,0,1255,59,20,54
1174561,1173801,760,0,719,41,19,52
1186539,1185652,887,0,857,30,20,53
1181870,1181110,760,0,729,31,20,49
1175863,1175550,313,7,287,19,18,41
1168414,1168087,327,0,293,34,20,43
1159953,1159033,920,0,884,36,20,48
1165745,1164941,804,0,797,7,19,51
1174360,1173536,824,0,787,37,19,51
1166805,1166269,536,0,525,11,19,50
1171824,1171661,163,0,159,4,17,30
1179089,1178929,160,0,141,19,18,37
1183816,1183277,539,0,516,23,18,47
1183791,1183295,496,12,462,22,19,45
1181829,1181625,204,0,200,4,14,28
1174541,1174448,93,0,83,10,15,25
1177859,1177243,616,0,592,24,19,47
1177968,1177729,239,0,238,1,18,34
1176510,1176419,91,0,85,6,13,28
1164770,1164034,736,0,697,39,18,48
1168290,1167255,1035,0,1001,34,20,52
1168031,1166721,1310,0,1229,81,19,54
1173013,1171883,1130,0,1118,12,19,53
1177219,1176352,867,0,840,27,20,52
1167204,1166307,897,50,831,16,20,52
1166063,1164815,1248,0,1192,56,18,49
1167348,1165857,1491,0,1432,59,20,54
1163334,1161924,1410,0,1399,11,18,53
1166533,1164554,1979,0,1924,55,19,54
1165272,1163845,1427,0,1407,20,20,54
1176761,1175485,1276,0,1210,66,19,53
1168726,1167231,1495,46,1441,8,20,54
1165086,1164251,835,66,752,17,18,54
1161614,1160239,1375,23,1275,77,20,53
1188236,1187065,1171,0,1156,15,19,54
1181606,1180531,1075,34,1034,7,20,52
1181456,1180244,1212,0,1154,58,20,54
1178305,1176359,1946,0,1846,100,19,54
1187022,1185520,1502,0,1442,60,19,53
1182865,1181694,1171,0,1141,30,19,54
1184692,1182837,1855,0,1760,95,20,53
1183407,1181994,1413,25,1345,43,20,54
1176799,1175414,1385,0,1346,39,19,53
1184116,1183026,1090,74,968,48,18,54
1191183,1190130,1053,27,995,31,20,54
1188944,1187948,996,0,926,70,20,54
1184203,1183089,1114,0,1087,27,19,54
1179409,1178623,786,0,739,47,19,50
1183159,1181915,1244,0,1223,21,19,53
1181838,1180986,852,0,816,36,20,53
1167527,1166728,799,0,769,30,19,52
1170750,1169217,1533,0,1514,19,19,53
1180556,1179219,1337,0,1313,24,20,54
1181530,1180094,1436,0,1387,49,19,54
1171028,1169549,1479,0,1388,91,19,54
1173314,1171712,1602,26,1554,22,20,53
1178711,1177808,903,0,862,41,20,54
1190616,1189896,720,0,673,47,20,53
1192386,1191312,1074,0,1050,24,18,53
1183645,1182351,1294,8,1249,37,19,53
1189843,1188519,1324,0,1239,85,19,53
1192625,1191171,1454,0,1384,70,20,53
1182706,1181558,1148,0,1106,42,18,52
1170485,1169204,1281,0,1252,29,19,53
1171703,1170608,1095,0,1041,54,20,54
1179993,1178891,1102,41,1037,24,19,51
1183839,1182561,1278,0,1202,76,20,52
1185701,1184526,1175,0,1150,25,20,52
1186493,1184862,1631,47,1498,86,20,54
1195066,1193703,1363,0,1337,26,19,53
1197963,1196632,1331,0,1268,63,20,51
1194813,1193516,1297,0,1239,58,20,51
1201388,1200391,997,0,983,14,19,53
1188129,1186365,1764,40,1655,69,20,54
1181601,1180467,1134,41,1078,15,17,48
1180594,1179432,1162,87,1057,18,20,53
1191600,1190176,1424,0,1404,20,18,54
1185726,1184288,1438,20,1352,66,20,54
1174948,1173935,1013,0,1006,7,19,54
1171890,1170345,1545,0,1455,90,20,54
1171105,1169807,1298,0,1228,70,20,54
1178545,1177078,1467,0,1405,62,20,53
1177093,1175585,1508,0,1478,30,20,54
1160745,1159907,838,0,804,34,20,53
1163091,1162313,778,2,743,33,19,51
1160541,1159365,1176,0,1084,92,20,54
1148537,1147416,1121,0,1079,42,19,53
1142864,1141681,1183,24,1097,62,19,54
1146931,1145835,1096,0,1068,28,19,54
1150168,1148978,1190,9,1128,53,19,54
1151879,1150949,930,0,916,14,19,54
1151204,1150111,1093,0,1038,55,19,49
1161428,1160340,1088,0,1059,29,20,53
1164354,1163397,957,0,887,70,19,53
1154078,1151674,2404,0,2328,76,20,54
1152094,1150881,1213,127,1054,32,20,54
1148857,1147786,1071,0,1036,35,20,53
1153730,1152244,1486,0,1462,24,19,54
1140706,1139792,914,0,890,24,18,49
1150549,1149511,1038,0,994,44,20,52
1168750,1167045,1705,78,1571,56,20,54
1186844,1185118,1726,0,1645,81,20,54
1202216,1200185,2031,0,1947,84,20,54
1216153,1214407,1746,0,1717,29,19,54
1219945,1218664,1281,0,1249,32,19,54
1217137,1215077,2060,0,2036,24,19,54
1220390,1218920,1470,0,1419,51,19,54
1224002,1222380,1622,0,1544,78,20,54
1220061,1218665,1396,0,1369,27,19,53
1214907,1213364,1543,0,1477,66,19,54
1216612,1215428,1184,14,1128,42,20,53
1220074,1219255,819,0,773,46,20,53
1223697,1222268,1429,0,1399,30,19,53
1228942,1227119,1823,0,1788,35,19,54
1226202,1224965,1237,0,1169,68,19,54
1218418,1217548,870,0,821,49,19,51
1222065,1220940,1125,0,1110,15,20,53
1221037,1219666,1371,0,1301,70,20,54
1224036,1223226,810,0,770,40,20,50
1202792,1202042,750,0,707,43,20,50
1195426,1194594,832,0,799,33,20,52
1207152,1206642,510,0,477,33,20,49
1218962,1218074,888,0,853,35,20,50
1215612,1214733,879,0,780,99,20,54
1210984,1210074,910,0,894,16,20,52
1206237,1205268,969,0,939,30,19,53
1203567,1201945,1622,0,1577,45,19,53
1199956,1198397,1559,0,1499,60,20,53
1190042,1189091,951,0,916,35,18,51
1198296,1197060,1236,30,1176,30,20,53
1185156,1183878,1278,0,1240,38,19,51
1185318,1184520,798,0,750,48,19,53
1192519,1191701,818,0,807,11,19,52
1192815,1192033,782,0,771,11,17,50
1172240,1170889,1351,0,1311,40,20,54
1173889,1172527,1362,23,1210,129,20,53
1187514,1186169,1345,0,1234,111,19,54
1193091,1192067,1024,0,975,49,19,52
1178396,1176256,2140,0,2053,87,20,54
1163075,1162090,985,37,899,49,20,52
1152186,1151017,1169,0,1122,47,19,54
1148575,1147655,920,0,858,62,20,51
1134273,1133457,816,0,796,20,19,52
1108235,1106575,1660,0,1573,87,19,53
1093865,1092668,1197,0,1172,25,19,54
1098141,1096253,1888,0,1854,34,20,54
1085603,1083746,1857,0,1773,84,19,53
1098906,1096942,1964,0,1861,103,20,54
1108359,1106649,1710,0,1642,68,20,54
1107556,1106133,1423,0,1335,88,20,53
1111578,1109881,1697,68,1574,55,20,54
1102554,1100778,1776,0,1647,129,19,54
1099591,1098368,1223,44,1106,73,20,54
1107424,1106171,1253,0,1152,101,19,54
1096582,1095351,1231,0,1214,17,20,51
1109158,1108033,1125,0,1025,100,20,54
1113256,1112329,927,23,888,16,17,51
1101947,1101162,785,39,725,21,20,52
1096076,1094908,1168,0,1117,51,19,54
1099433,1098663,770,0,743,27,20,51
1096977,1096140,837,0,808,29,19,53
1087687,1086876,811,0,770,41,20,52
1094988,1094419,569,0,564,5,18,44
1110797,1110151,646,30,610,6,20,51
1112245,1111528,717,0,673,44,19,51
1113392,1112019,1373,0,1327,46,20,54
1117011,1116014,997,0,990,7,19,53
1104145,1103162,983,0,960,23,18,52
1111923,1111558,365,0,361,4,20,43
1123445,1122945,500,0,495,5,19,49
1123239,1122400,839,15,730,94,20,53
1128397,1127538,859,0,816,43,19,51
1128818,1127636,1182,0,1108,74,20,52
1134004,1132396,1608,45,1470,93,20,54
1130334,1129340,994,69,903,22,18,46
1109825,1108621,1204,0,1170,34,19,54
1111374,1110498,876,0,839,37,20,53
1135610,1134356,1254,0,1195,59,20,54
1155140,1154054,1086,0,1065,21,20,53
1168997,1168225,772,0,749,23,20,51
1168298,1167168,1130,0,1031,99,19,52
1179346,1177863,1483,0,1431,52,19,54
1223974,1222492,1482,0,1411,71,19,53
1260589,1258591,1998,33,1864,101,20,54
1284829,1283025,1804,0,1745,59,19,54
1283140,1280928,2212,0,2092,120,18,52
1310650,1308837,1813,0,1740,73,19,54
1327912,1326876,1036,0,990,46,20,52
1338019,1336748,1271,0,1243,28,19,50
1338351,1336880,1471,31,1401,39,20,53
1341976,1340752,1224,0,1205,19,20,54
1368987,1367159,1828,0,1749,79,20,53
1387616,1385818,1798,119,1641,38,20,54
1397648,1396495,1153,0,1111,42,18,52
1410484,1409492,992,0,960,32,20,53
1498177,1497211,966,0,933,33,19,52
1511241,1509084,2157,0,2056,101,20,54
1537534,1535330,2204,0,2176,28,20,54
1569528,1568424,1104,36,1008,60,20,45
1580630,1579513,1117,0,1043,74,18,50
1605435,1604234,1201,0,1123,78,20,53
1632275,1629879,2396,0,2287,109,20,54
1653493,1650959,2534,0,2410,124,19,54
1662171,1658773,3398,0,3314,84,19,54
1666039,1664221,1818,49,1687,82,20,54
1697695,1695244,2451,0,2354,97,20,54
1748523,1746181,2342,0,2205,137,19,54
1758250,1756697,1553,82,1461,10,20,53
1737241,1735560,1681,0,1598,83,19,53
1752810,1750599,2211,0,2206,5,20,54
1778166,1776000,2166,0,2080,86,20,52
1851076,1849857,1219,0,1187,32,19,54
1865051,1863781,1270,0,1237,33,20,53
1876624,1874717,1907,0,1864,43,18,53
1913647,1911766,1881,0,1845,36,18,53
1918613,1916305,2308,0,2223,85,20,54
1913347,1910532,2815,0,2776,39,19,53
1892933,1890946,1987,0,1922,65,20,54
1879989,1877377,2612,0,2593,19,19,54
1833557,1832465,1092,0,1048,44,19,54
1802706,1800516,2190,0,2160,30,20,54
1790914,1788281,2633,163,2438,32,20,53
1759973,1757873,2100,0,2061,39,20,54
1731088,1729135,1953,0,1897,56,20,54
1723594,1721406,2188,64,2092,32,20,54
1680043,1678268,1775,31,1657,87,20,54
1653695,1651469,2226,0,2173,53,19,54
1634784,1633144,1640,0,1576,64,19,54
1612956,1611518,1438,0,1425,13,20,53
2655510,2653472,2038,0,2027,11,18,43
2643487,2640956,2531,0,2485,46,18,54
2572610,2570440,2170,0,2103,67,20,50
2960302,2957719,2583,0,2505,78,18,54
2984186,2980846,3340,0,3287,53,19,54
2948499,2944447,4052,0,3957,95,19,54
2945786,2941753,4033,0,3907,126,19,54
2920285,2914338,5947,0,5709,238,20,53
2936212,2932972,3240,0,3128,112,19,52
2956652,2953147,3505,0,3387,118,19,51
3008582,3004211,4371,302,3851,218,20,54
3016614,3011891,4723,0,4641,82,20,54
3009966,3005594,4372,0,4229,143,20,54
3031965,3027777,4188,0,4015,173,20,54
3016602,3011627,4975,0,4818,157,20,54
3036797,3033423,3374,0,3253,121,20,53
3122698,3118487,4211,239,3845,127,18,54
3132504,3128228,4276,0,4213,63,19,53
3127496,3123536,3960,290,3535,135,20,54
3165143,3161582,3561,0,3364,197,19,54
3198615,3190923,7692,0,7464,228,20,54
3193709,3179043,14666,0,14046,620,20,53
3195735,3181650,14085,0,13669,416,19,54
3206466,3199541,6925,0,6729,196,20,54
3255173,3247551,7622,0,7221,401,19,54
3251876,3246943,4933,0,4551,382,19,54
