coverage,wt.counts,mut.count,s.count,ns.count,stp.count,aa.sampled,codons.sampled
716757,716757,0,0,0,0,0,0
728105,728105,0,0,0,0,0,0
745110,745076,34,0,34,0,3,3
756193,756172,21,0,21,0,5,5
767227,767121,106,0,106,0,9,11
780138,780043,95,54,41,0,4,7
781276,781075,201,0,201,0,11,19
795056,795051,5,0,5,0,2,2
801538,801475,63,0,63,0,7,9
821487,821433,54,0,54,0,3,5
828264,828264,0,0,0,0,0,0
839585,839554,31,0,31,0,5,6
844726,844726,0,0,0,0,0,0
861882,861882,0,0,0,0,0,0
862408,862338,70,0,70,0,5,8
353709,338203,15506,15,15491,0,15,35
363398,363335,63,25,38,0,5,6
369298,369225,73,0,73,0,8,13
379307,379272,35,0,35,0,3,6
386508,386357,151,9,142,0,11,16
389860,389546,314,0,314,0,11,15
390149,390077,72,0,72,0,6,8
398223,398217,6,0,6,0,1,2
403398,403298,100,0,100,0,10,14
405737,405719,18,0,18,0,3,4
418118,418013,105,0,105,0,7,13
418036,418022,14,0,14,0,1,2
419343,419250,93,0,93,0,7,13
411408,411365,43,0,43,0,3,7
408867,408829,38,0,38,0,1,2
406193,406176,17,0,17,0,2,2
399776,399770,6,0,6,0,1,1
392243,392243,0,0,0,0,0,0
385009,385005,4,0,4,0,1,1
391595,391595,0,0,0,0,0,0
394984,394984,0,0,0,0,0,0
392034,392033,1,0,1,0,1,1
398717,398717,0,0,0,0,0,0
395348,395340,8,0,8,0,3,3
387244,386016,1228,6,1222,0,1,3
388347,388338,9,0,9,0,2,2
388115,388115,0,0,0,0,0,0
388155,388155,0,0,0,0,0,0
389535,389532,3,0,3,0,2,2
386663,386646,17,0,17,0,6,7
383003,382913,90,0,90,0,8,11
375382,374607,775,0,775,0,12,20
373389,373236,153,0,153,0,10,19
370754,370748,6,0,6,0,1,1
365683,365667,16,0,16,0,3,3
357441,357378,63,0,63,0,7,7
359117,359081,36,0,36,0,2,6
352957,352952,5,0,5,0,2,2
346375,346353,22,0,22,0,3,5
340117,340040,77,0,77,0,6,9
336259,336259,0,0,0,0,0,0
332645,332604,41,0,41,0,3,7
327144,327139,5,0,5,0,1,2
323494,323494,0,0,0,0,0,0
322078,322024,54,0,54,0,3,5
315014,315011,3,0,3,0,1,1
313528,313491,37,0,37,0,7,10
308552,308552,0,0,0,0,0,0
309109,309076,33,1,32,0,3,5
303858,303745,113,33,80,0,12,16
301091,301091,0,0,0,0,0,0
302666,302662,4,0,4,0,1,1
302117,302109,8,8,0,0,0,1
300589,300577,12,0,12,0,4,4
303992,303992,0,0,0,0,0,0
305809,305809,0,0,0,0,0,0
298536,298366,170,0,170,0,3,3
295354,295354,0,0,0,0,0,0
299518,299518,0,0,0,0,0,0
296569,296569,0,0,0,0,0,0
297012,296992,20,0,20,0,4,5
296889,296889,0,0,0,0,0,0
291315,291315,0,0,0,0,0,0
283618,283597,21,21,0,0,0,3
297539,297539,0,0,0,0,0,0
287121,287102,19,19,0,0,0,2
295914,295903,11,0,11,0,2,2
293779,293772,7,6,1,0,1,3
291767,291308,459,13,446,0,3,8
293918,293910,8,0,8,0,1,2
295594,295585,9,0,9,0,2,2
296026,296012,14,6,8,0,2,3
302547,302547,0,0,0,0,0,0
303915,303915,0,0,0,0,0,0
304394,304380,14,0,14,0,2,2
306238,306236,2,0,2,0,1,1
303630,303629,1,0,1,0,1,1
311141,311141,0,0,0,0,0,0
314077,314069,8,0,8,0,3,3
317059,317059,0,0,0,0,0,0
318440,318436,4,0,4,0,1,1
322998,322996,2,0,2,0,2,2
327683,327683,0,0,0,0,0,0
327039,327039,0,0,0,0,0,0
329290,329290,0,0,0,0,0,0
330900,330880,20,0,20,0,3,3
332294,332294,0,0,0,0,0,0
331195,331187,8,0,8,0,1,2
328166,328166,0,0,0,0,0,0
330190,330188,2,0,2,0,1,1
325998,325966,32,0,32,0,8,8
324540,324540,0,0,0,0,0,0
327291,327286,5,0,5,0,1,1
329257,329250,7,0,7,0,3,3
327177,327176,1,0,1,0,1,1
327949,327924,25,11,14,0,2,3
329298,329098,200,0,200,0,11,22
327565,327544,21,0,21,0,4,7
332434,332269,165,13,152,0,8,10
339333,339333,0,0,0,0,0,0
329538,329538,0,0,0,0,0,0
328858,328846,12,0,12,0,3,3
333521,333516,5,0,5,0,1,1
337625,337620,5,0,5,0,2,2
344270,344270,0,0,0,0,0,0
347649,347625,24,0,24,0,4,5
353205,353204,1,0,1,0,1,1
352339,352338,1,0,1,0,1,1
348381,348325,56,0,56,0,4,8
352557,352557,0,0,0,0,0,0
354292,354292,0,0,0,0,0,0
352845,352844,1,0,1,0,1,1
354261,354224,37,0,37,0,2,5
356637,356633,4,0,4,0,2,2
356109,356096,13,0,13,0,2,3
357402,357401,1,1,0,0,0,1
357370,357370,0,0,0,0,0,0
354106,354106,0,0,0,0,0,0
356262,356262,0,0,0,0,0,0
355319,355293,26,21,5,0,2,3
356129,356129,0,0,0,0,0,0
355298,355298,0,0,0,0,0,0
357159,357155,4,0,4,0,2,2
356263,356035,228,0,228,0,9,13
360173,360173,0,0,0,0,0,0
362732,362726,6,0,6,0,2,3
361654,361654,0,0,0,0,0,0
365339,365283,56,0,56,0,7,9
365942,365934,8,6,2,0,1,2
364846,364793,53,0,53,0,4,9
366200,366200,0,0,0,0,0,0
363091,363091,0,0,0,0,0,0
362114,362114,0,0,0,0,0,0
360660,360660,0,0,0,0,0,0
357540,357524,16,0,16,0,2,2
359946,359929,17,0,17,0,1,1
353576,353575,1,0,1,0,1,1
349842,349841,1,0,1,0,1,1
349599,349481,118,0,118,0,4,5
347227,347176,51,14,37,0,2,6
347787,347759,28,6,22,0,5,10
343190,343163,27,0,27,0,6,6
335505,335497,8,4,4,0,2,3
331989,331986,3,0,3,0,2,2
333812,333812,0,0,0,0,0,0
331486,331486,0,0,0,0,0,0
331068,331018,50,0,50,0,3,5
329898,329894,4,0,4,0,2,2
326237,326237,0,0,0,0,0,0
323498,323497,1,0,1,0,1,1
321427,321335,92,0,92,0,7,13
319257,319253,4,0,4,0,2,2
317872,317872,0,0,0,0,0,0
310236,310235,1,0,1,0,1,1
308573,308549,24,24,0,0,0,2
307301,307301,0,0,0,0,0,0
305308,305305,3,3,0,0,0,1
304759,304742,17,0,17,0,2,3
304800,304752,48,0,48,0,5,8
302896,302892,4,0,4,0,1,1
305589,305589,0,0,0,0,0,0
304139,304114,25,0,25,0,3,4
302593,302593,0,0,0,0,0,0
307041,307041,0,0,0,0,0,0
306443,306443,0,0,0,0,0,0
306536,306377,159,0,159,0,2,3
301282,301282,0,0,0,0,0,0
299896,299895,1,0,1,0,1,1
301263,301263,0,0,0,0,0,0
300920,300919,1,0,1,0,1,1
298183,298178,5,0,5,0,1,1
300253,300252,1,0,1,0,1,1
298376,298376,0,0,0,0,0,0
301690,301690,0,0,0,0,0,0
302199,302171,28,0,28,0,4,6
303814,303805,9,3,6,0,1,2
304006,304006,0,0,0,0,0,0
301944,301938,6,0,6,0,4,4
301544,301532,12,0,12,0,4,4
300582,300557,25,0,25,0,6,7
302397,302378,19,0,19,0,4,5
301528,301504,24,0,24,0,1,1
297986,297977,9,0,9,0,2,2
297229,297222,7,0,7,0,3,3
297170,297170,0,0,0,0,0,0
298936,298913,23,0,23,0,2,4
301882,301881,1,0,1,0,1,1
303511,303509,2,0,2,0,1,1
302186,302178,8,0,8,0,4,4
301696,301513,183,0,183,0,7,7
295174,278215,16959,14,16945,0,18,43
300371,297555,2816,0,2816,0,9,22
306308,306301,7,0,7,0,1,1
305192,304973,219,0,219,0,9,16
307294,307289,5,0,5,0,2,2
308401,307182,1219,3,1216,0,14,30
306904,306345,559,8,551,0,16,36
304170,304020,150,0,150,0,11,22
299537,299531,6,0,6,0,3,4
299320,299314,6,5,1,0,1,2
299484,299477,7,0,7,0,4,4
298946,298936,10,0,10,0,1,3
296580,296571,9,0,9,0,3,4
293565,293562,3,0,3,0,1,2
297413,297314,99,6,93,0,12,17
295070,294932,138,0,138,0,7,9
290202,290171,31,0,31,0,6,9
296141,296141,0,0,0,0,0,0
292819,292817,2,0,2,0,1,1
292341,292249,92,0,92,0,10,16
292159,292158,1,0,1,0,1,1
287795,287696,99,0,99,0,9,11
287426,287415,11,0,11,0,3,4
284180,284164,16,0,16,0,6,7
284000,283857,143,0,143,0,9,12
287508,287347,161,5,156,0,11,21
291904,291875,29,0,29,0,6,8
289321,288806,515,0,515,0,9,15
289518,289350,168,0,168,0,5,8
286819,285390,1429,0,1429,0,16,34
288416,288231,185,3,182,0,8,14
287627,287596,31,0,31,0,6,8
288571,288571,0,0,0,0,0,0
287965,287842,123,11,112,0,5,8
287044,287035,9,0,9,0,3,3
287493,287465,28,0,28,0,6,7
288921,288848,73,0,73,0,8,14
286142,286131,11,0,11,0,1,1
285089,285060,29,0,29,0,5,8
283322,283314,8,0,8,0,3,4
284459,284442,17,0,17,0,4,4
285062,285062,0,0,0,0,0,0
284754,284745,9,0,9,0,1,2
282883,282861,22,0,22,0,3,4
280884,280802,82,0,82,0,5,11
279355,279354,1,0,0,1,1,1
278850,278850,0,0,0,0,0,0
279482,279467,15,12,3,0,2,4
279495,279477,18,0,18,0,5,6
279241,279223,18,0,18,0,2,3
282058,282058,0,0,0,0,0,0
283639,283637,2,0,2,0,1,2
284605,284605,0,0,0,0,0,0
282820,282819,1,0,1,0,1,1
281804,281802,2,0,2,0,2,2
284039,284039,0,0,0,0,0,0
283793,283792,1,0,1,0,1,1
284192,284191,1,0,1,0,1,1
284540,284537,3,3,0,0,0,1
286540,286540,0,0,0,0,0,0
286313,286311,2,0,2,0,1,1
284076,284076,0,0,0,0,0,0
283722,283711,11,6,5,0,1,4
283248,283220,28,0,28,0,2,3
282116,282114,2,0,2,0,1,1
277794,277785,9,0,9,0,2,3
279194,279194,0,0,0,0,0,0
280546,280544,2,0,2,0,1,1
281801,281799,2,0,2,0,2,2
281370,281370,0,0,0,0,0,0
279746,279739,7,0,7,0,2,2
278753,278753,0,0,0,0,0,0
278445,278427,18,16,2,0,2,5
277794,277792,2,0,2,0,2,2
281169,281169,0,0,0,0,0,0
281107,281018,89,0,89,0,1,1
281286,281286,0,0,0,0,0,0
277721,277713,8,0,8,0,2,4
278571,278537,34,0,34,0,6,6
277685,277667,18,0,18,0,3,4
282479,282477,2,2,0,0,0,1
284041,284039,2,0,2,0,1,1
288891,288875,16,0,16,0,4,5
286031,285974,57,0,57,0,6,10
286967,286919,48,0,48,0,6,10
289511,289511,0,0,0,0,0,0
289489,289484,5,0,5,0,2,2
288964,288964,0,0,0,0,0,0
292962,292882,80,0,80,0,4,7
293912,293910,2,0,2,0,1,1
293586,293580,6,0,6,0,2,2
291582,291582,0,0,0,0,0,0
295154,295150,4,0,4,0,1,2
295613,295575,38,0,38,0,6,10
296271,296270,1,0,1,0,1,1
296767,296763,4,0,4,0,1,1
297647,297621,26,0,26,0,1,1
298312,298276,36,0,36,0,4,6
301661,301630,31,0,31,0,6,7
301832,301824,8,0,8,0,3,3
302594,302586,8,7,1,0,1,2
303135,303117,18,0,18,0,2,3
304217,304177,40,0,40,0,1,3
305355,305302,53,0,53,0,6,10
305108,305106,2,0,2,0,2,2
306522,306522,0,0,0,0,0,0
303214,303211,3,0,3,0,1,1
305725,305725,0,0,0,0,0,0
310292,310269,23,0,23,0,3,6
309195,309162,33,0,33,0,1,3
306625,306552,73,0,73,0,4,5
306116,306116,0,0,0,0,0,0
304957,304953,4,0,4,0,1,1
301840,301825,15,0,15,0,2,2
305527,305360,167,0,167,0,10,16
305158,305113,45,0,45,0,2,5
305963,305963,0,0,0,0,0,0
301646,301645,1,0,1,0,1,1
298296,298291,5,0,5,0,1,1
297619,297619,0,0,0,0,0,0
297092,297080,12,12,0,0,0,2
300500,300477,23,23,0,0,0,1
301628,301603,25,4,21,0,3,6
297503,297499,4,0,4,0,2,2
297058,296862,196,0,196,0,14,23
294186,293956,230,0,230,0,12,23
296769,296769,0,0,0,0,0,0
300209,300208,1,0,1,0,1,1
296243,296233,10,10,0,0,0,3
297141,297141,0,0,0,0,0,0
296669,296643,26,0,26,0,2,3
293089,293063,26,0,26,0,1,2
298576,298512,64,0,64,0,9,17
300445,300445,0,0,0,0,0,0
301975,301975,0,0,0,0,0,0
301533,301533,0,0,0,0,0,0
302146,302110,36,36,0,0,0,4
301611,301605,6,0,6,0,2,2
304613,304611,2,0,2,0,1,1
301911,301910,1,0,1,0,1,1
304274,304272,2,0,2,0,1,1
303725,303725,0,0,0,0,0,0
304291,304291,0,0,0,0,0,0
300905,300905,0,0,0,0,0,0
301293,301293,0,0,0,0,0,0
301405,301405,0,0,0,0,0,0
303601,303601,0,0,0,0,0,0
307112,307100,12,10,2,0,1,2
306748,306747,1,0,1,0,1,1
309280,309262,18,0,18,0,2,2
313740,313737,3,0,3,0,2,2
312894,312888,6,0,6,0,3,3
313867,313867,0,0,0,0,0,0
312194,312194,0,0,0,0,0,0
314285,314283,2,0,2,0,2,2
315380,315380,0,0,0,0,0,0
315525,315513,12,0,12,0,7,7
313675,313664,11,0,11,0,2,2
311057,311057,0,0,0,0,0,0
310865,310838,27,0,27,0,4,7
311056,311055,1,0,1,0,1,1
311792,311770,22,0,22,0,5,6
287542,287537,5,0,5,0,1,1
309298,309288,10,0,10,0,1,1
310580,310578,2,0,2,0,1,1
315379,315368,11,0,11,0,4,6
313522,313518,4,0,4,0,1,1
310186,301406,8780,0,8780,0,10,24
309037,309037,0,0,0,0,0,0
307964,307948,16,15,1,0,1,2
306139,306037,102,0,102,0,3,5
307299,307298,1,0,1,0,1,1
307533,307525,8,0,8,0,2,2
310048,310032,16,0,16,0,5,5
308349,308349,0,0,0,0,0,0
306176,306165,11,0,11,0,1,2
309195,309193,2,0,2,0,1,1
309787,309784,3,0,3,0,2,2
311614,311604,10,0,10,0,1,3
309613,309591,22,0,22,0,1,3
313119,313114,5,0,5,0,2,2
316109,316104,5,0,5,0,3,3
314660,314608,52,0,52,0,8,12
312211,312211,0,0,0,0,0,0
315845,315755,90,0,90,0,6,13
312494,306572,5922,0,5922,0,14,34
319065,319045,20,0,20,0,4,4
315838,315768,70,0,70,0,7,10
316235,316032,203,0,203,0,5,7
307621,287762,19859,0,19859,0,10,29
322545,322497,48,29,19,0,5,9
320985,320977,8,0,8,0,1,1
324772,324772,0,0,0,0,0,0
330664,330644,20,0,20,0,4,5
331157,331157,0,0,0,0,0,0
332402,332105,297,0,297,0,12,27
333643,333622,21,0,21,0,3,5
335186,335158,28,0,28,0,7,7
335562,335558,4,0,4,0,2,2
336704,336670,34,17,17,0,2,5
336437,336430,7,7,0,0,0,2
333566,333549,17,0,17,0,3,3
333342,333297,45,0,45,0,4,6
334868,334806,62,0,62,0,3,6
337654,337532,122,1,121,0,9,20
340628,340583,45,0,45,0,7,9
339494,339465,29,0,29,0,4,5
338933,338671,262,0,262,0,12,17
337820,337819,1,0,1,0,1,1
339419,339413,6,0,6,0,3,3
337087,337057,30,0,30,0,5,7
340000,339996,4,0,4,0,2,2
341055,341021,34,0,34,0,7,9
338913,338909,4,2,2,0,2,3
336920,336911,9,0,9,0,3,3
333956,333940,16,0,16,0,2,2
335483,335482,1,0,1,0,1,1
333221,333088,133,0,133,0,10,19
334015,333987,28,8,20,0,6,8
333462,333280,182,25,157,0,12,20
328982,328968,14,0,14,0,6,7
327894,327885,9,0,9,0,2,2
329773,329619,154,21,133,0,7,11
323498,323490,8,0,8,0,1,1
319100,319100,0,0,0,0,0,0
317888,317886,2,0,2,0,2,2
315601,315593,8,3,5,0,3,4
316415,316415,0,0,0,0,0,0
316307,316306,1,0,1,0,1,1
314962,314922,40,0,40,0,3,5
310757,310747,10,0,10,0,1,2
308865,308849,16,0,16,0,4,4
310605,310605,0,0,0,0,0,0
310142,310142,0,0,0,0,0,0
308524,308524,0,0,0,0,0,0
307151,307150,1,0,1,0,1,1
308912,308912,0,0,0,0,0,0
310354,310344,10,8,2,0,2,3
311834,311834,0,0,0,0,0,0
310600,310589,11,11,0,0,0,2
310410,310354,56,0,56,0,3,6
309524,309523,1,0,1,0,1,1
306823,306814,9,8,1,0,1,2
305831,305830,1,0,1,0,1,1
303894,303894,0,0,0,0,0,0
308048,308036,12,0,12,0,1,2
306521,306521,0,0,0,0,0,0
307123,307115,8,0,8,0,2,4
301518,301518,0,0,0,0,0,0
299916,299900,16,8,8,0,1,4
299730,299726,4,0,4,0,2,3
299196,299192,4,0,4,0,2,2
297942,297917,25,0,25,0,2,4
300241,300224,17,0,17,0,1,1
302339,302338,1,0,1,0,1,1
295396,295393,3,0,3,0,1,1
294388,294369,19,0,19,0,2,2
297743,297743,0,0,0,0,0,0
296668,296650,18,8,10,0,2,5
296237,296222,15,0,15,0,2,4
298472,298472,0,0,0,0,0,0
297834,297826,8,2,6,0,2,3
296991,296991,0,0,0,0,0,0
293774,293774,0,0,0,0,0,0
294181,294181,0,0,0,0,0,0
298568,298561,7,0,7,0,1,2
298396,298394,2,0,2,0,1,1
302990,302939,51,0,51,0,10,14
297615,297615,0,0,0,0,0,0
297918,297771,147,0,147,0,10,20
292652,292600,52,0,52,0,8,13
298549,298548,1,1,0,0,0,1
297768,297746,22,0,22,0,4,4
299268,299265,3,0,3,0,1,1
299782,299779,3,0,3,0,2,2
300255,300255,0,0,0,0,0,0
300683,300668,15,15,0,0,0,1
300989,300983,6,0,6,0,1,1
298103,298099,4,0,4,0,2,2
297731,297730,1,0,1,0,1,1
297960,297919,41,0,41,0,5,7
293195,293180,15,0,15,0,3,3
291737,291737,0,0,0,0,0,0
288767,288767,0,0,0,0,0,0
291657,291656,1,0,1,0,1,1
291991,291990,1,0,1,0,1,1
293185,293174,11,11,0,0,0,1
292716,292716,0,0,0,0,0,0
290606,290602,4,3,1,0,1,2
289445,289418,27,24,3,0,1,4
290070,289982,88,0,88,0,4,9
289980,289953,27,0,27,0,2,3
291191,291186,5,5,0,0,0,1
287425,286336,1089,0,1089,0,4,7
285274,285260,14,0,14,0,3,4
285227,285225,2,0,2,0,2,2
283537,283537,0,0,0,0,0,0
284092,284088,4,0,4,0,1,2
285583,285583,0,0,0,0,0,0
288650,288649,1,0,1,0,1,1
288147,288147,0,0,0,0,0,0
289357,289354,3,0,3,0,2,2
280577,280574,3,0,3,0,1,1
282796,282793,3,2,1,0,1,2
274312,274304,8,0,8,0,2,2
279285,279267,18,0,18,0,1,2
278507,278321,186,0,186,0,10,19
278709,278549,160,10,150,0,15,23
276223,276215,8,0,8,0,3,3
276870,276846,24,0,24,0,4,6
273824,273824,0,0,0,0,0,0
272880,272862,18,0,18,0,1,3
270754,270689,65,0,65,0,9,13
270703,270696,7,0,7,0,3,3
268623,268623,0,0,0,0,0,0
268116,268093,23,0,23,0,4,5
272121,272114,7,0,7,0,2,2
271091,271091,0,0,0,0,0,0
273692,273677,15,0,15,0,2,5
272695,272693,2,0,2,0,2,2
273228,273227,1,0,1,0,1,1
269412,269412,0,0,0,0,0,0
270173,270173,0,0,0,0,0,0
271014,271012,2,0,2,0,1,1
271363,271343,20,0,20,0,2,4
277172,277170,2,0,2,0,1,1
280761,280730,31,0,31,0,2,3
278469,278466,3,0,3,0,1,1
277658,277610,48,0,48,0,5,9
278566,278493,73,0,73,0,8,14
278795,278682,113,0,113,0,6,10
279955,279218,737,0,737,0,6,11
283248,282198,1050,14,1036,0,9,14
283706,283178,528,10,518,0,7,14
283614,283507,107,0,107,0,4,6
285866,285772,94,0,94,0,8,16
284043,284039,4,0,4,0,2,2
282976,282975,1,0,1,0,1,1
282990,282976,14,0,14,0,3,3
284066,284033,33,0,33,0,1,1
282774,282752,22,0,22,0,6,8
282091,282084,7,7,0,0,0,1
280390,280379,11,0,11,0,1,2
279333,279332,1,0,1,0,1,1
274499,274498,1,0,1,0,1,1
278094,278094,0,0,0,0,0,0
276236,276235,1,0,1,0,1,1
276508,276505,3,2,1,0,1,2
273946,273943,3,0,3,0,1,1
273655,273654,1,1,0,0,0,1
269878,269874,4,0,4,0,2,2
272621,272615,6,5,1,0,1,3
273801,273799,2,0,2,0,1,1
270246,270246,0,0,0,0,0,0
266476,266472,4,0,4,0,3,3
264624,264602,22,0,22,0,6,7
267609,267607,2,0,2,0,2,2
270186,270132,54,0,54,0,7,13
276498,276250,248,5,243,0,11,22
278204,278203,1,0,1,0,1,1
273507,256058,17449,0,17449,0,17,44
273685,273267,418,0,418,0,9,22
269767,269758,9,0,9,0,1,2
270177,270047,130,0,130,0,6,8
264977,264972,5,0,5,0,2,2
272687,272687,0,0,0,0,0,0
270445,270358,87,0,87,0,8,15
270477,270351,126,0,126,0,15,26
275136,275047,89,0,89,0,5,11
275390,275185,205,0,205,0,10,20
279375,279131,244,0,244,0,14,28
279419,279369,50,0,50,0,6,7
279820,279744,76,0,76,0,7,10
279629,279516,113,0,113,0,12,18
277798,277625,173,0,173,0,9,20
274126,273875,251,0,251,0,14,20
279897,279813,84,0,84,0,5,11
280783,280679,104,14,90,0,11,19
282396,282394,2,0,2,0,1,2
285636,285601,35,0,35,0,5,8
286504,286492,12,0,12,0,2,3
286444,286444,0,0,0,0,0,0
284984,284955,29,0,29,0,7,9
286714,286687,27,0,27,0,6,7
289204,289141,63,0,63,0,6,12
292972,292962,10,0,10,0,3,4
293535,293466,69,0,69,0,8,12
293147,292992,155,0,155,0,9,11
296071,296071,0,0,0,0,0,0
295302,295028,274,10,264,0,4,11
296750,296581,169,0,169,0,5,7
297894,297832,62,0,62,0,8,12
299697,299697,0,0,0,0,0,0
303250,303250,0,0,0,0,0,0
304335,304322,13,0,13,0,3,3
305147,305141,6,6,0,0,0,1
301726,301726,0,0,0,0,0,0
302155,302151,4,0,4,0,1,1
303421,303393,28,0,28,0,4,5
306991,306991,0,0,0,0,0,0
307784,307784,0,0,0,0,0,0
306641,306640,1,0,1,0,1,1
309253,309253,0,0,0,0,0,0
311896,311896,0,0,0,0,0,0
310014,310008,6,0,6,0,1,2
303079,303079,0,0,0,0,0,0
303157,303157,0,0,0,0,0,0
301659,301642,17,0,17,0,2,2
301818,301818,0,0,0,0,0,0
300947,300947,0,0,0,0,0,0
301248,301248,0,0,0,0,0,0
299732,299588,144,0,144,0,3,4
299255,299016,239,0,239,0,5,5
297543,297543,0,0,0,0,0,0
298778,298775,3,0,3,0,1,1
296845,296838,7,7,0,0,0,1
295440,295362,78,0,77,1,10,14
293723,293723,0,0,0,0,0,0
294559,294437,122,0,122,0,12,20
293952,293952,0,0,0,0,0,0
292184,292141,43,0,43,0,7,10
289340,289340,0,0,0,0,0,0
289123,289064,59,22,37,0,3,7
287255,287255,0,0,0,0,0,0
290891,290872,19,8,11,0,2,4
289842,289842,0,0,0,0,0,0
292433,292433,0,0,0,0,0,0
290901,290869,32,0,32,0,3,5
289499,289472,27,0,27,0,4,5
287661,287661,0,0,0,0,0,0
286387,286387,0,0,0,0,0,0
285731,285731,0,0,0,0,0,0
282891,282891,0,0,0,0,0,0
287547,287545,2,0,2,0,1,1
287291,287291,0,0,0,0,0,0
285986,285984,2,0,2,0,1,1
286079,286079,0,0,0,0,0,0
282828,282826,2,0,2,0,1,1
283698,283697,1,0,1,0,1,1
286793,286787,6,0,6,0,1,2
284930,284923,7,0,7,0,3,3
283996,283900,96,0,96,0,8,9
288708,288691,17,0,17,0,7,7
287778,287778,0,0,0,0,0,0
286383,285825,558,0,558,0,14,27
285702,285689,13,0,13,0,3,3
282757,282568,189,4,185,0,12,23
285054,285035,19,0,19,0,5,5
285341,285316,25,0,25,0,3,4
284580,284442,138,0,138,0,10,14
287081,287047,34,0,34,0,6,7
287069,287060,9,0,9,0,1,1
285197,285189,8,0,8,0,1,1
284926,284916,10,0,10,0,3,4
285627,285609,18,0,18,0,2,3
282480,282314,166,0,166,0,12,20
285250,285243,7,0,7,0,3,4
285691,285678,13,0,13,0,1,3
284065,283923,142,0,142,0,6,12
283660,283628,32,2,30,0,6,7
282853,282824,29,0,29,0,5,7
284990,284988,2,0,2,0,1,1
282680,282669,11,0,11,0,2,5
279079,279079,0,0,0,0,0,0
279112,279109,3,1,2,0,1,2
278540,278538,2,2,0,0,0,1
280798,280783,15,12,3,0,2,4
277858,277858,0,0,0,0,0,0
276891,276876,15,5,10,0,2,5
276852,276852,0,0,0,0,0,0
274060,274042,18,0,18,0,5,6
266690,266690,0,0,0,0,0,0
278330,278326,4,0,4,0,2,2
275536,275535,1,0,1,0,1,1
277334,277313,21,0,21,0,5,5
276140,276134,6,3,3,0,1,2
273347,273347,0,0,0,0,0,0
273048,273048,0,0,0,0,0,0
274543,274543,0,0,0,0,0,0
277104,277104,0,0,0,0,0,0
278520,278508,12,0,12,0,3,3
281575,281575,0,0,0,0,0,0
281649,281649,0,0,0,0,0,0
286036,286036,0,0,0,0,0,0
286273,286273,0,0,0,0,0,0
283555,283517,38,0,38,0,4,6
280770,280767,3,1,2,0,1,2
283365,283320,45,0,45,0,7,12
281883,281753,130,0,130,0,6,10
281940,281875,65,0,65,0,9,13
279975,279845,130,0,130,0,10,14
281670,281639,31,6,25,0,7,9
285686,285555,131,0,131,0,12,19
288663,288563,100,0,100,0,11,22
290492,290300,192,0,192,0,13,25
294134,294067,67,0,67,0,11,16
296040,295967,73,0,73,0,12,20
296801,296784,17,0,17,0,2,3
294031,293984,47,0,47,0,7,12
297527,297453,74,0,74,0,4,6
299958,299886,72,0,72,0,8,14
296039,296034,5,0,5,0,3,3
297349,297334,15,0,15,0,2,3
297716,297714,2,0,2,0,1,1
295634,295634,0,0,0,0,0,0
291136,291136,0,0,0,0,0,0
293833,293833,0,0,0,0,0,0
299317,299317,0,0,0,0,0,0
300234,300234,0,0,0,0,0,0
296725,296724,1,0,1,0,1,1
295549,295549,0,0,0,0,0,0
294901,294901,0,0,0,0,0,0
294691,294691,0,0,0,0,0,0
296491,296486,5,0,5,0,3,3
298359,298344,15,0,15,0,3,5
294369,294369,0,0,0,0,0,0
290825,290811,14,0,14,0,4,4
289719,289625,94,0,94,0,10,23
289784,289732,52,0,52,0,11,13
289601,289569,32,0,32,0,4,4
290201,290165,36,11,25,0,4,7
289527,289527,0,0,0,0,0,0
291957,291952,5,0,5,0,2,2
291409,291409,0,0,0,0,0,0
289671,289671,0,0,0,0,0,0
290244,290244,0,0,0,0,0,0
290521,290520,1,1,0,0,0,1
291270,291270,0,0,0,0,0,0
291427,291427,0,0,0,0,0,0
291187,291187,0,0,0,0,0,0
285621,285609,12,12,0,0,0,2
284105,284082,23,0,23,0,1,3
278359,278359,0,0,0,0,0,0
278024,278024,0,0,0,0,0,0
276197,276156,41,0,41,0,5,10
273207,273205,2,0,2,0,1,1
267052,266984,68,0,68,0,2,4
261183,261171,12,0,12,0,5,5
266336,266336,0,0,0,0,0,0
268233,268224,9,0,9,0,2,3
266854,266844,10,0,10,0,3,3
264717,264712,5,5,0,0,0,1
263711,263710,1,0,1,0,1,1
261067,261064,3,3,0,0,0,2
256045,256042,3,0,3,0,2,2
258159,258159,0,0,0,0,0,0
255945,255945,0,0,0,0,0,0
258986,258983,3,3,0,0,0,1
259601,259596,5,0,5,0,1,1
258179,258179,0,0,0,0,0,0
254209,254209,0,0,0,0,0,0
251084,251081,3,0,3,0,2,2
254059,254057,2,0,2,0,1,1
255583,255583,0,0,0,0,0,0
251184,251184,0,0,0,0,0,0
248177,248174,3,0,3,0,1,1
247961,247960,1,0,1,0,1,1
247996,247996,0,0,0,0,0,0
246247,246247,0,0,0,0,0,0
244813,244813,0,0,0,0,0,0
243196,243196,0,0,0,0,0,0
246276,246248,28,14,14,0,5,7
244980,244957,23,0,23,0,3,6
246341,246340,1,0,1,0,1,1
246633,246472,161,12,149,0,11,17
245225,245212,13,6,7,0,1,5
242922,242673,249,0,249,0,13,23
243030,243019,11,0,11,0,1,1
246281,246096,185,0,185,0,12,21
247521,247520,1,0,1,0,1,1
250058,250058,0,0,0,0,0,0
255215,254824,391,0,391,0,16,26
258601,258593,8,0,8,0,3,4
263643,263630,13,0,13,0,4,6
263940,263905,35,23,12,0,4,6
269939,269931,8,0,8,0,2,3
271917,271861,56,0,56,0,8,15
271373,271366,7,0,7,0,2,2
277709,277709,0,0,0,0,0,0
280197,280161,36,0,36,0,4,5
282864,282854,10,0,10,0,2,2
288509,288509,0,0,0,0,0,0
284829,284821,8,0,8,0,4,4
280208,280192,16,13,3,0,1,4
289631,289630,1,0,1,0,1,1
291056,291054,2,0,2,0,1,1
294838,294831,7,0,7,0,2,3
296143,296089,54,0,54,0,10,16
298952,298903,49,0,49,0,6,12
300756,300740,16,0,16,0,2,3
307178,307140,38,0,38,0,5,5
315340,315301,39,0,39,0,5,7
319326,319281,45,0,45,0,8,12
320863,320843,20,0,20,0,6,7
326995,326750,245,0,245,0,14,31
329356,329356,0,0,0,0,0,0
337793,337715,78,0,78,0,10,18
340631,340628,3,0,3,0,1,2
351044,351039,5,5,0,0,0,1
353210,353181,29,0,29,0,1,1
356610,356609,1,0,1,0,1,1
357748,357735,13,0,13,0,1,1
363887,363886,1,0,1,0,1,1
365724,365719,5,0,5,0,1,1
372938,372937,1,0,1,0,1,1
372889,372889,0,0,0,0,0,0
376947,376928,19,0,19,0,4,4
378886,378854,32,0,32,0,6,10
377865,377841,24,0,24,0,4,6
379155,379153,2,0,2,0,1,1
377797,377779,18,0,18,0,2,2
378131,378130,1,0,1,0,1,1
369917,369913,4,4,0,0,0,1
367563,367558,5,0,5,0,2,2
364138,364131,7,0,7,0,3,3
359049,359032,17,17,0,0,0,1
355607,355596,11,8,3,0,2,3
348169,348139,30,0,30,0,3,3
334405,328184,6221,0,6221,0,13,25
343498,343498,0,0,0,0,0,0
341194,338881,2313,0,2313,0,13,29
756546,728189,28357,0,28357,0,14,25
784297,783971,326,0,326,0,6,10
782094,779650,2444,0,2444,0,14,28
783644,783472,172,0,172,0,10,15
773798,773489,309,0,309,0,8,15
768898,768867,31,0,31,0,3,4
747527,747523,4,0,4,0,1,1
744159,744008,151,0,151,0,9,11
736245,736213,32,0,32,0,2,3
722037,719916,2121,30,2091,0,12,25
698282,683961,14321,0,14320,1,20,41
700983,700971,12,0,12,0,2,3
688825,688812,13,0,13,0,4,4
673587,673049,538,0,538,0,12,23
659394,657745,1649,0,1649,0,9,18
648784,648763,21,21,0,0,0,1
639514,639167,347,0,347,0,12,19
632171,632072,99,40,59,0,8,15
622133,622115,18,0,18,0,3,3
608630,608393,237,0,237,0,12,23
597199,596821,378,0,377,1,16,35
581971,581671,300,0,300,0,11,16
577149,576887,262,0,262,0,12,20
561352,561331,21,0,21,0,4,5
554977,554956,21,0,21,0,5,6
