coverage,wt.counts,mut.count,s.count,ns.count,stp.count,aa.sampled,codons.sampled
749912,749046,866,0,866,0,19,19
753087,752174,913,55,858,0,19,20
750371,749670,701,0,701,0,19,19
745538,744726,812,27,785,0,19,20
760236,759270,966,0,925,41,20,20
757536,756597,939,0,939,0,19,19
756696,755887,809,0,809,0,19,19
751972,751088,884,0,884,0,19,19
743060,742263,797,67,730,0,19,20
757591,756621,970,0,930,40,20,20
766853,766289,564,0,564,0,19,19
505920,505383,537,36,501,0,19,20
500419,499894,525,0,525,0,19,19
523956,523505,451,0,451,0,19,19
541501,540976,525,0,525,0,19,19
564730,564171,559,0,559,0,19,19
579497,578943,554,0,554,0,19,19
598020,597428,592,0,592,0,19,19
605681,605086,595,0,559,36,20,20
625385,624706,679,40,639,0,19,20
630281,629584,697,0,661,36,20,20
637747,637124,623,0,623,0,19,19
636571,635850,721,0,691,30,20,20
642405,641726,679,0,679,0,19,19
655542,654888,654,31,623,0,19,20
657877,657336,541,0,541,0,19,19
669203,668481,722,0,722,0,19,19
670091,669405,686,0,686,0,19,19
677308,676537,771,0,725,46,20,20
683857,683214,643,0,643,0,19,19
686328,685612,716,0,716,0,19,19
698665,698039,626,0,626,0,19,19
702786,702186,600,0,600,0,19,19
706291,705662,629,0,629,0,19,19
714630,713893,737,0,737,0,19,19
702744,702007,737,0,737,0,19,19
705556,704826,730,0,730,0,19,19
715314,714671,643,0,643,0,19,19
713899,713184,715,25,690,0,19,20
711574,710845,729,35,694,0,19,20
702583,701840,743,0,680,63,20,20
703294,702636,658,30,628,0,19,20
692181,691443,738,0,738,0,19,19
681232,680515,717,0,717,0,19,19
670154,669586,568,50,518,0,19,20
657730,657055,675,0,633,42,20,20
636358,635843,515,0,515,0,19,19
627834,627147,687,0,657,30,20,20
622369,621393,976,36,940,0,19,20
625791,625127,664,0,613,51,20,20
621867,621224,643,0,624,19,20,20
619958,619421,537,0,537,0,19,19
617911,617244,667,0,639,28,20,20
609705,609055,650,0,606,44,20,20
593206,592478,728,0,700,28,20,20
588951,588368,583,0,583,0,19,19
589349,588805,544,0,544,0,19,19
589417,588688,729,33,696,0,19,20
587727,587169,558,0,558,0,19,19
591236,590697,539,0,539,0,19,19
590740,590105,635,0,572,63,20,20
597496,596918,578,0,578,0,19,19
592105,591533,572,0,572,0,19,19
596034,595494,540,24,516,0,19,20
602271,601658,613,0,613,0,19,19
602151,601565,586,26,560,0,19,20
609947,609303,644,0,604,40,20,20
608642,608115,527,0,527,0,19,19
610320,609604,716,0,688,28,20,20
606735,606053,682,0,650,32,20,20
606820,606214,606,0,606,0,19,19
604620,604061,559,0,559,0,19,19
605947,605342,605,32,573,0,19,20
604795,604049,746,29,717,0,19,20
605393,604813,580,0,580,0,19,19
603141,602508,633,0,633,0,19,19
605850,605223,627,0,627,0,19,19
616708,616177,531,0,531,0,19,19
615522,614908,614,34,580,0,19,20
616593,615922,671,0,671,0,19,19
619926,619300,626,0,626,0,19,19
618639,617586,1053,22,1031,0,19,20
620018,619316,702,0,702,0,19,19
620464,619743,721,0,721,0,19,19
611167,610383,784,0,784,0,19,19
612018,611334,684,0,650,34,20,20
614327,613483,844,42,802,0,19,20
613107,612359,748,0,720,28,20,20
606702,606053,649,0,649,0,19,19
607019,606379,640,0,640,0,19,19
608170,607630,540,0,540,0,19,19
612229,611527,702,0,702,0,19,19
611327,610486,841,0,841,0,19,19
619611,618825,786,0,786,0,19,19
620220,619437,783,0,783,0,19,19
610971,610248,723,0,723,0,19,19
614155,613515,640,0,640,0,19,19
615088,614523,565,33,532,0,19,20
611888,611157,731,0,731,0,19,19
619519,618832,687,0,687,0,19,19
632838,632175,663,0,663,0,19,19
635687,635018,669,0,669,0,19,19
631637,630786,851,0,827,24,20,20
633332,632697,635,0,635,0,19,19
637340,636645,695,0,695,0,19,19
633506,632774,732,0,732,0,19,19
643239,642492,747,0,747,0,19,19
649565,648851,714,0,714,0,19,19
650271,649457,814,0,766,48,20,20
651633,651006,627,0,627,0,19,19
658710,657982,728,0,728,0,19,19
663688,662905,783,0,783,0,19,19
659301,658449,852,0,852,0,19,19
661484,660752,732,0,732,0,19,19
676580,675728,852,59,793,0,19,20
676859,676000,859,0,828,31,20,20
676020,675283,737,0,737,0,19,19
679929,679139,790,0,790,0,19,19
693046,692006,1040,53,987,0,19,20
697344,696283,1061,50,1011,0,19,20
695113,694248,865,0,823,42,20,20
703618,702796,822,0,822,0,19,19
700815,699855,960,0,909,51,20,20
702247,701449,798,0,772,26,20,20
706104,705213,891,0,825,66,20,20
702225,701396,829,0,829,0,19,19
709854,709088,766,0,766,0,19,19
700738,699961,777,0,777,0,19,19
707297,706564,733,0,733,0,19,19
705380,704443,937,0,879,58,20,20
713773,713059,714,0,714,0,19,19
716534,715831,703,0,703,0,19,19
712489,711752,737,0,737,0,19,19
718081,717169,912,0,912,0,19,19
707754,706781,973,0,973,0,19,19
712622,711647,975,0,975,0,19,19
712800,711786,1014,0,952,62,20,20
720097,719015,1082,52,1030,0,19,20
725447,724618,829,0,829,0,19,19
719940,719125,815,40,775,0,19,20
727287,726314,973,29,944,0,19,20
732558,731414,1144,0,1144,0,19,19
735942,734871,1071,0,1013,58,20,20
733878,732669,1209,0,1147,62,20,20
739527,738709,818,0,818,0,19,19
739641,738702,939,0,865,74,20,20
732406,731606,800,0,800,0,19,19
738723,738018,705,0,705,0,19,19
743509,742661,848,0,806,42,20,20
737896,737248,648,0,648,0,19,19
738855,738019,836,0,836,0,19,19
738399,737624,775,0,775,0,19,19
739750,738771,979,72,907,0,19,20
734342,733460,882,0,882,0,19,19
740052,739204,848,0,848,0,19,19
734570,733675,895,0,895,0,19,19
741323,740525,798,0,798,0,19,19
735555,734475,1080,55,1025,0,19,20
732662,731609,1053,0,1053,0,19,19
733792,732873,919,0,919,0,19,19
736348,735543,805,0,805,0,19,19
739048,738085,963,28,935,0,19,20
737758,736901,857,0,857,0,19,19
737439,736589,850,56,794,0,19,20
733140,732239,901,0,901,0,18,18
727035,726262,773,0,773,0,19,19
728677,727713,964,0,888,76,20,20
727141,726382,759,0,759,0,19,19
730595,729555,1040,0,1040,0,19,19
721721,720903,818,0,818,0,19,19
725829,724975,854,0,854,0,19,19
723578,722727,851,0,851,0,19,19
726261,725208,1053,39,1014,0,19,20
727602,726571,1031,0,1031,0,19,19
719611,718731,880,0,880,0,19,19
724784,723901,883,0,883,0,19,19
719828,718991,837,0,784,53,20,20
716786,715866,920,0,867,53,20,20
712310,711469,841,0,841,0,19,19
713265,712519,746,0,746,0,19,19
720148,719295,853,0,799,54,20,20
720846,719930,916,66,850,0,19,20
716634,715888,746,0,746,0,19,19
706019,705275,744,0,744,0,19,19
702087,701223,864,0,864,0,19,19
710475,709546,929,0,889,40,20,20
704495,703626,869,51,818,0,19,20
699960,699139,821,0,821,0,19,19
712783,712007,776,0,776,0,19,19
708656,707795,861,0,861,0,19,19
714163,713350,813,0,813,0,19,19
705194,704386,808,0,808,0,19,19
712862,712026,836,0,836,0,19,19
714472,713697,775,0,775,0,19,19
711854,710999,855,44,811,0,19,20
710917,710004,913,0,868,45,20,20
714592,713805,787,42,745,0,19,20
722192,721358,834,0,834,0,19,19
718840,717966,874,61,813,0,19,20
725452,724676,776,39,737,0,19,20
722889,721898,991,0,956,35,20,20
724550,723388,1162,33,1129,0,19,20
723171,722313,858,0,858,0,19,19
720450,719474,976,38,938,0,19,20
717601,716778,823,0,823,0,19,19
720232,719288,944,0,903,41,20,20
721777,720801,976,0,976,0,19,19
723837,723168,669,0,669,0,19,19
722139,721182,957,43,914,0,19,20
723791,723035,756,0,756,0,19,19
722024,721184,840,0,840,0,19,19
707681,706672,1009,43,966,0,19,20
711509,710598,911,0,911,0,19,19
712199,711452,747,0,747,0,19,19
709561,708652,909,62,847,0,19,20
711291,710620,671,0,671,0,19,19
708568,707634,934,0,934,0,19,19
707439,706425,1014,0,948,66,20,20
697998,697080,918,0,871,47,20,20
700807,699927,880,0,857,23,20,20
708106,707204,902,0,866,36,20,20
710989,710200,789,0,789,0,19,19
707994,706988,1006,0,1006,0,19,19
705338,704451,887,0,844,43,20,20
706705,705860,845,0,845,0,19,19
700123,699212,911,0,871,40,20,20
706390,705582,808,44,764,0,19,20
709223,708540,683,0,683,0,19,19
705739,705042,697,0,697,0,19,19
711156,710547,609,0,609,0,19,19
714835,714297,538,0,538,0,19,19
712921,712259,662,24,638,0,19,20
716184,715470,714,0,714,0,19,19
725497,724887,610,0,610,0,19,19
729723,729100,623,0,623,0,19,19
732586,731926,660,0,660,0,19,19
736940,736187,753,0,753,0,19,19
729779,729087,692,0,660,32,20,20
723211,722568,643,0,643,0,19,19
735117,734432,685,0,685,0,19,19
735262,734586,676,0,676,0,19,19
737216,736557,659,0,659,0,19,19
740350,739701,649,0,649,0,19,19
737691,737125,566,0,566,0,19,19
743729,743057,672,0,672,0,19,19
743158,742407,751,0,720,31,20,20
738224,737550,674,0,614,60,20,20
742099,741517,582,0,582,0,19,19
738414,737770,644,0,644,0,19,19
737132,736485,647,39,608,0,19,20
740073,739390,683,0,683,0,19,19
743643,742887,756,22,734,0,19,20
750407,749847,560,0,560,0,19,19
753869,753232,637,0,637,0,19,19
761336,760616,720,0,720,0,19,19
762567,761994,573,0,573,0,19,19
758719,758061,658,0,658,0,19,19
754133,753484,649,0,649,0,19,19
754820,754145,675,34,641,0,19,20
747794,747010,784,0,784,0,19,19
754099,753419,680,55,625,0,19,20
769152,768440,712,0,712,0,19,19
767711,767021,690,0,642,48,20,20
772529,771874,655,0,655,0,19,19
742676,742110,566,0,566,0,19,19
769228,768654,574,0,574,0,19,19
764436,763767,669,0,669,0,19,19
770272,769474,798,33,765,0,19,20
776321,775645,676,0,676,0,19,19
776252,775560,692,0,692,0,19,19
782949,782223,726,0,726,0,19,19
793350,792725,625,0,625,0,19,19
793673,793005,668,0,668,0,19,19
798850,798036,814,0,814,0,19,19
802669,801844,825,0,776,49,20,20
792678,792022,656,52,604,0,19,20
795727,794974,753,0,753,0,19,19
794742,793951,791,26,765,0,19,20
786846,786149,697,0,697,0,19,19
783043,782395,648,0,648,0,19,19
781143,780418,725,0,725,0,19,19
781207,780441,766,0,766,0,19,19
784061,783395,666,35,631,0,19,20
778022,777436,586,0,586,0,19,19
781233,780540,693,0,693,0,19,19
779002,778365,637,0,637,0,19,19
783389,782786,603,0,603,0,19,19
778171,777583,588,0,588,0,19,19
775192,774359,833,0,833,0,19,19
728367,727706,661,0,661,0,19,19
762718,762109,609,0,609,0,19,19
757809,757166,643,0,643,0,19,19
752270,751518,752,0,752,0,19,19
750479,749677,802,0,802,0,19,19
754831,754260,571,0,571,0,19,19
762750,762063,687,29,658,0,19,20
760391,759758,633,0,633,0,19,19
761947,761312,635,0,635,0,19,19
763009,762456,553,29,524,0,19,20
767654,767118,536,20,516,0,19,20
762342,761614,728,0,676,52,20,20
760409,759723,686,0,686,0,19,19
756648,755854,794,0,753,41,20,20
749947,749371,576,0,576,0,19,19
750729,749992,737,0,737,0,19,19
747632,746890,742,0,742,0,19,19
746351,745574,777,0,732,45,20,20
734248,733465,783,0,743,40,20,20
741293,740638,655,0,655,0,19,19
733843,733107,736,0,697,39,20,20
724397,723661,736,0,736,0,19,19
727790,727078,712,0,655,57,20,20
718867,718171,696,0,696,0,19,19
716410,715692,718,0,718,0,19,19
716055,715300,755,0,709,46,20,20
714708,714007,701,36,665,0,19,20
708761,708043,718,20,698,0,19,20
708109,707295,814,0,814,0,19,19
716233,715540,693,0,693,0,19,19
711852,711261,591,0,591,0,19,19
722478,721426,1052,0,1052,0,19,19
736003,735322,681,0,681,0,19,19
739462,738750,712,0,712,0,19,19
739548,738870,678,0,678,0,19,19
745743,745120,623,0,623,0,19,19
740744,740056,688,0,688,0,19,19
746184,745534,650,0,650,0,19,19
748405,747764,641,0,641,0,19,19
751066,750265,801,59,742,0,19,20
753862,753025,837,0,810,27,20,20
756711,756040,671,0,671,0,19,19
747491,746703,788,0,788,0,19,19
750320,749500,820,48,772,0,19,20
751798,750974,824,0,779,45,20,20
745831,745181,650,0,650,0,19,19
753088,752273,815,44,771,0,19,20
754902,754289,613,0,613,0,19,19
754757,754100,657,0,657,0,19,19
744655,743930,725,0,725,0,19,19
742756,742036,720,0,720,0,19,19
737256,736578,678,0,678,0,19,19
729873,729153,720,0,720,0,19,19
741636,740811,825,0,794,31,20,20
747680,746544,1136,0,1136,0,19,19
727884,727168,716,0,716,0,19,19
738853,738106,747,0,719,28,20,20
748161,747356,805,0,769,36,20,20
745774,745055,719,0,719,0,19,19
744592,743878,714,0,714,0,19,19
749402,748580,822,0,822,0,19,19
751476,750820,656,17,639,0,19,20
752295,751310,985,28,957,0,19,20
748484,747825,659,50,609,0,19,20
752655,751611,1044,0,1044,0,19,19
748168,747412,756,0,756,0,19,19
752677,752034,643,0,643,0,19,19
744185,743395,790,33,757,0,19,20
740254,739548,706,51,655,0,19,20
725070,724295,775,0,775,0,19,19
722455,721894,561,0,561,0,19,19
708298,707615,683,0,683,0,19,19
705316,704702,614,0,614,0,19,19
711635,710849,786,0,741,45,20,20
705397,704673,724,0,700,24,20,20
707352,706694,658,0,658,0,19,19
700454,699763,691,0,691,0,19,19
709650,708886,764,0,764,0,19,19
711184,710593,591,33,558,0,19,20
709999,709258,741,0,741,0,19,19
710448,709764,684,0,684,0,19,19
704630,703848,782,0,782,0,19,19
708476,707740,736,0,736,0,19,19
719409,718841,568,0,568,0,19,19
726236,725629,607,0,607,0,19,19
733158,732468,690,0,690,0,19,19
739694,738982,712,0,712,0,19,19
743294,742666,628,0,628,0,19,19
745993,745459,534,0,503,31,20,20
759896,759456,440,0,440,0,19,19
766841,766254,587,0,574,13,20,20
766454,765885,569,0,540,29,20,20
768238,767598,640,0,640,0,19,19
764213,763606,607,34,573,0,19,20
766079,765179,900,0,848,52,20,20
768864,768104,760,0,760,0,19,19
764454,763772,682,0,656,26,20,20
770605,769847,758,0,758,0,19,19
774599,773853,746,0,746,0,19,19
769636,768901,735,0,686,49,20,20
764860,764190,670,0,670,0,19,19
764972,764270,702,0,702,0,19,19
770712,769951,761,0,729,32,20,20
758566,757807,759,63,696,0,19,20
762178,761579,599,0,599,0,19,19
761517,760859,658,0,658,0,19,19
763240,762413,827,58,769,0,19,20
769480,768862,618,0,618,0,19,19
774888,774186,702,0,702,0,19,19
779248,778552,696,44,652,0,19,20
781533,780821,712,0,712,0,19,19
785623,784800,823,0,782,41,20,20
782571,781918,653,0,653,0,19,19
779727,778891,836,0,836,0,19,19
778434,777613,821,0,772,49,20,20
790243,789495,748,30,718,0,19,20
785143,784321,822,0,769,53,20,20
780922,780233,689,0,689,0,19,19
780134,779375,759,0,759,0,19,19
783992,783209,783,0,758,25,20,20
766358,765570,788,0,726,62,20,20
782663,781985,678,0,678,0,19,19
768036,767310,726,0,726,0,19,19
764230,763565,665,0,641,24,20,20
762771,762142,629,0,629,0,19,19
749600,748942,658,30,628,0,19,20
754690,753901,789,0,731,58,20,20
758823,758059,764,0,764,0,19,19
754699,754039,660,37,623,0,19,20
752270,751518,752,0,752,0,19,19
756007,755323,684,33,651,0,19,20
750275,749578,697,0,697,0,19,19
746686,745911,775,0,775,0,19,19
755129,754455,674,65,609,0,19,20
754687,754002,685,0,685,0,19,19
757479,756839,640,0,640,0,19,19
757371,756708,663,0,615,48,20,20
760681,760068,613,0,613,0,19,19
755923,755269,654,0,654,0,19,19
751936,751274,662,0,662,0,19,19
754227,753566,661,0,661,0,19,19
760896,760273,623,31,592,0,19,20
758937,758276,661,0,661,0,19,19
749390,748795,595,0,595,0,19,19
748441,747622,819,0,819,0,19,19
753533,752756,777,0,777,0,19,19
741063,739988,1075,24,1051,0,19,20
733911,733237,674,0,674,0,19,19
746113,745455,658,0,658,0,19,19
752088,751438,650,16,634,0,19,20
750702,749938,764,32,732,0,19,20
743746,743022,724,0,724,0,19,19
748539,747822,717,0,717,0,19,19
745774,745136,638,0,638,0,19,19
741449,740705,744,0,744,0,19,19
760504,759741,763,0,763,0,19,19
766116,765367,749,34,715,0,19,20
764967,764387,580,0,580,0,19,19
769022,768324,698,0,698,0,19,19
764819,764131,688,34,654,0,19,20
767805,767048,757,0,757,0,19,19
770548,769707,841,0,802,39,20,20
787650,786972,678,0,678,0,19,19
783746,782725,1021,0,1021,0,19,19
795008,794360,648,0,648,0,19,19
789058,788312,746,0,746,0,19,19
788264,787581,683,0,683,0,19,19
789554,788847,707,0,707,0,19,19
792264,791517,747,26,721,0,19,20
793369,792761,608,0,608,0,19,19
787942,787354,588,45,543,0,19,20
786902,786269,633,0,633,0,19,19
781144,780422,722,0,722,0,19,19
790215,789668,547,0,508,39,20,20
796049,795464,585,0,585,0,19,19
793019,792304,715,0,715,0,19,19
794282,793699,583,0,583,0,19,19
787692,786655,1037,0,979,58,20,20
789870,788967,903,0,903,0,19,19
785740,784790,950,0,893,57,20,20
782954,782062,892,45,847,0,19,20
789391,788482,909,45,864,0,19,20
787136,786340,796,30,766,0,19,20
778262,777446,816,0,816,0,19,19
781829,780910,919,0,870,49,20,20
788879,788096,783,0,783,0,19,19
783026,782172,854,0,854,0,19,19
789254,788471,783,0,783,0,19,19
789584,788883,701,0,667,34,20,20
791335,790556,779,0,779,0,19,19
784925,784107,818,0,818,0,19,19
780258,779434,824,24,800,0,19,20
788622,787626,996,35,961,0,19,20
794166,793164,1002,83,919,0,19,20
791513,790828,685,0,685,0,19,19
788489,787869,620,0,579,41,19,19
789862,789083,779,0,779,0,19,19
790046,789192,854,47,807,0,19,20
790786,789936,850,46,804,0,19,20
792348,791260,1088,22,1066,0,19,20
782995,782226,769,0,769,0,19,19
781605,780929,676,0,676,0,19,19
777760,776990,770,23,747,0,19,20
770597,769697,900,0,835,65,20,20
764131,763431,700,0,700,0,19,19
768062,767042,1020,0,1020,0,19,19
755623,754824,799,27,772,0,19,20
750966,750177,789,0,789,0,19,19
749209,748477,732,0,732,0,19,19
742297,741662,635,0,635,0,19,19
746216,745534,682,0,682,0,19,19
759597,758885,712,0,712,0,19,19
761445,760572,873,39,834,0,19,20
755510,754787,723,0,655,68,20,20
752204,751322,882,0,836,46,20,20
751691,751057,634,0,634,0,19,19
753240,752544,696,0,696,0,19,19
754587,753905,682,0,682,0,19,19
756819,755950,869,36,833,0,19,20
750023,749367,656,0,656,0,19,19
747063,746340,723,0,723,0,19,19
754444,753324,1120,0,1120,0,19,19
762560,761759,801,0,801,0,19,19
774608,773742,866,0,811,55,20,20
776667,775858,809,0,809,0,19,19
777926,777138,788,0,788,0,19,19
767933,767142,791,51,740,0,19,20
761188,760489,699,0,699,0,19,19
759859,759142,717,0,717,0,19,19
756199,755158,1041,0,1041,0,19,19
761006,760250,756,0,756,0,19,19
751382,750675,707,0,707,0,19,19
740275,739544,731,0,731,0,19,19
737320,736541,779,0,779,0,19,19
731539,730822,717,30,687,0,19,20
728889,728145,744,0,744,0,19,19
730901,729951,950,0,950,0,19,19
731615,730794,821,36,785,0,19,20
728750,728053,697,0,697,0,19,19
721810,721063,747,0,747,0,19,19
715755,715059,696,0,696,0,19,19
712927,712119,808,0,783,25,20,20
722971,722273,698,0,698,0,19,19
723259,722589,670,28,642,0,19,20
719830,719121,709,0,709,0,19,19
715705,714882,823,0,823,0,19,19
721330,720573,757,0,757,0,19,19
715369,714642,727,35,692,0,19,20
713335,712574,761,0,761,0,19,19
711831,711159,672,0,672,0,19,19
704560,704071,489,0,489,0,19,19
703411,702842,569,0,569,0,19,19
703569,702965,604,0,576,28,20,20
706332,705865,467,14,453,0,19,20
694827,693994,833,0,833,0,19,19
691871,691449,422,0,396,26,20,20
689418,688981,437,0,437,0,18,18
683963,683201,762,0,762,0,19,19
679881,679039,842,35,807,0,19,20
675593,674807,786,55,731,0,19,20
671217,670442,775,49,726,0,19,20
653326,652589,737,0,737,0,19,19
650145,649412,733,0,733,0,19,19
648535,647743,792,0,792,0,19,19
646250,645600,650,0,650,0,19,19
657920,657210,710,0,710,0,19,19
658938,658222,716,0,716,0,19,19
662371,661562,809,35,774,0,19,20
657332,656564,768,0,737,31,20,20
656915,656120,795,0,795,0,19,19
655920,655172,748,45,703,0,19,20
649374,648637,737,35,702,0,19,20
653753,653003,750,0,699,51,20,20
654518,653792,726,0,726,0,19,19
653651,652882,769,37,732,0,19,20
653123,652353,770,0,770,0,19,19
662923,662210,713,0,686,27,20,20
665850,665012,838,0,838,0,19,19
668284,667558,726,0,726,0,19,19
669362,668531,831,0,804,27,20,20
673227,672385,842,0,803,39,20,20
666506,665778,728,0,728,0,19,19
667216,666456,760,0,760,0,19,19
674390,673639,751,0,710,41,20,20
675370,674544,826,0,826,0,19,19
677189,676467,722,0,722,0,19,19
681750,681050,700,0,682,18,20,20
685328,684561,767,30,737,0,19,20
682142,681463,679,0,679,0,19,19
685096,684311,785,0,785,0,19,19
681539,680852,687,24,663,0,19,20
675204,674511,693,0,693,0,19,19
672432,671712,720,0,720,0,19,19
676918,676080,838,35,803,0,19,20
681099,680336,763,0,731,32,20,20
686325,685287,1038,30,1008,0,19,20
689045,688262,783,0,783,0,19,19
676831,676044,787,0,747,40,20,20
673074,672315,759,0,759,0,19,19
677110,676203,907,0,850,57,20,20
667426,666780,646,0,646,0,19,19
678809,678133,676,0,634,42,20,20
677919,676850,1069,13,1056,0,19,20
674010,673415,595,0,595,0,19,19
657196,656542,654,0,654,0,19,19
653630,652845,785,0,785,0,19,19
659270,658601,669,0,669,0,19,19
648024,647278,746,34,712,0,19,20
645373,644617,756,0,756,0,19,19
645796,645082,714,0,714,0,19,19
653583,652906,677,53,624,0,19,20
648557,647922,635,0,635,0,18,18
652197,651544,653,0,653,0,19,19
655001,654232,769,42,727,0,19,20
653145,652446,699,0,699,0,19,19
650026,649371,655,0,655,0,19,19
647608,646902,706,0,706,0,19,19
649162,648503,659,28,631,0,19,20
649224,648382,842,0,842,0,19,19
647825,647059,766,0,766,0,19,19
654430,653820,610,0,610,0,19,19
656289,655552,737,0,737,0,19,19
657735,657076,659,0,659,0,19,19
659111,658432,679,0,679,0,19,19
662677,662068,609,0,609,0,19,19
660234,659213,1021,45,976,0,19,20
662125,661368,757,0,757,0,19,19
668577,667851,726,42,684,0,19,20
671561,670724,837,0,837,0,19,19
678561,677778,783,38,745,0,19,20
684895,683973,922,0,851,71,20,20
690126,689411,715,0,683,32,20,20
681397,680670,727,0,706,21,20,20
685433,684555,878,0,832,46,20,20
685809,684825,984,0,984,0,19,19
688637,687862,775,0,775,0,19,19
692232,691501,731,0,731,0,19,19
700993,700073,920,34,886,0,19,20
703102,702314,788,0,788,0,19,19
698793,697952,841,0,795,46,20,20
697909,697304,605,0,605,0,19,19
704840,704002,838,28,810,0,19,20
705161,704233,928,0,928,0,19,19
710182,709418,764,0,764,0,19,19
704068,703363,705,0,705,0,19,19
708588,707768,820,0,820,0,19,19
706242,705505,737,0,737,0,19,19
699471,698727,744,0,744,0,19,19
700004,699190,814,0,814,0,19,19
697118,696278,840,0,784,56,20,20
697323,696504,819,0,819,0,19,19
691021,690358,663,0,663,0,19,19
689196,688439,757,52,705,0,19,20
685404,684645,759,0,722,37,20,20
682249,681515,734,0,734,0,19,19
686972,686020,952,0,952,0,19,19
687939,687206,733,0,733,0,19,19
674971,674222,749,0,749,0,19,19
689423,688738,685,0,685,0,19,19
680260,679531,729,0,729,0,19,19
678853,678180,673,32,641,0,19,20
676217,675490,727,24,703,0,19,20
678448,677703,745,56,689,0,19,20
672659,671996,663,0,663,0,19,19
674285,673447,838,0,802,36,20,20
669376,668741,635,0,635,0,19,19
663945,663289,656,0,656,0,19,19
663840,662955,885,0,885,0,19,19
667736,667057,679,0,679,0,19,19
661608,660967,641,0,620,21,20,20
660571,659582,989,0,989,0,19,19
668812,667949,863,44,819,0,19,20
659589,658825,764,0,764,0,19,19
655065,654092,973,0,973,0,19,19
654163,653468,695,0,695,0,19,19
651422,650734,688,0,688,0,19,19
641917,641169,748,0,748,0,19,19
637041,636376,665,0,665,0,19,19
635429,634643,786,0,786,0,19,19
626297,625560,737,0,737,0,19,19
627190,626495,695,0,660,35,20,20
628202,627543,659,0,659,0,19,19
629708,629071,637,0,637,0,19,19
626033,625331,702,0,702,0,19,19
620352,619651,701,0,669,32,20,20
615190,614524,666,0,666,0,19,19
614390,613867,523,0,523,0,19,19
615259,614373,886,0,886,0,19,19
613649,613046,603,0,603,0,19,19
603964,603456,508,0,508,0,19,19
596891,596426,465,0,465,0,19,19
602724,602166,558,0,558,0,19,19
595710,595130,580,0,580,0,19,19
594634,593820,814,16,798,0,19,20
586890,586215,675,0,675,0,19,19
587864,586993,871,36,835,0,19,20
583301,582601,700,0,700,0,19,19
585394,584829,565,0,565,0,19,19
595516,594759,757,50,707,0,19,20
592400,591743,657,0,657,0,19,19
593796,593107,689,0,689,0,19,19
583085,582328,757,0,720,37,20,20
591950,591336,614,0,614,0,19,19
590028,589436,592,0,566,26,20,20
595861,595277,584,0,584,0,19,19
602485,601990,495,0,495,0,19,19
606674,606050,624,30,594,0,19,20
609403,608822,581,0,555,26,20,20
622067,621573,494,0,494,0,19,19
629775,629342,433,0,433,0,19,19
639311,639010,301,0,301,0,19,19
646053,645400,653,0,653,0,19,19
657973,657046,927,0,927,0,19,19
664709,663722,987,0,987,0,19,19
670049,668894,1155,0,1093,62,20,20
684729,683868,861,0,861,0,19,19
694377,693413,964,0,964,0,19,19
702567,701686,881,0,881,0,19,19
721162,720202,960,0,902,58,20,20
727496,726520,976,68,908,0,19,20
736175,735175,1000,0,1000,0,19,19
747699,746579,1120,51,1069,0,19,20
762368,760974,1394,0,1394,0,19,19
768649,767748,901,0,901,0,19,19
780391,779320,1071,0,1071,0,19,19
808148,807055,1093,0,1093,0,19,19
820752,819731,1021,0,1021,0,19,19
828376,827252,1124,0,1124,0,19,19
867162,866102,1060,0,1060,0,19,19
876708,875697,1011,0,1011,0,19,19
890604,889356,1248,0,1198,50,20,20
927177,925952,1225,0,1225,0,19,19
942608,941288,1320,0,1320,0,19,19
953088,951772,1316,0,1249,67,20,20
981095,979957,1138,83,1055,0,19,20
993736,992258,1478,74,1404,0,19,20
992928,991547,1381,54,1327,0,19,20
989791,988568,1223,0,1223,0,19,19
992687,991272,1415,58,1357,0,19,20
1017401,1016040,1361,100,1261,0,19,20
1033422,1032306,1116,0,1116,0,19,19
1025834,1024462,1372,0,1372,0,19,19
1028181,1026838,1343,0,1343,0,19,19
1029689,1028433,1256,0,1256,0,19,19
1032501,1030696,1805,0,1805,0,19,19
1028610,1027130,1480,0,1392,88,20,20
1022698,1021366,1332,0,1332,0,19,19
1021474,1019992,1482,0,1400,82,20,20
1034603,1033256,1347,0,1347,0,19,19
1027727,1026263,1464,0,1387,77,20,20
1023422,1021994,1428,0,1350,78,20,20
1019998,1018882,1116,0,1116,0,19,19
1018724,1017440,1284,0,1284,0,19,19
1019286,1017905,1381,39,1342,0,19,20
1006114,1004678,1436,0,1344,92,20,20
998756,997405,1351,0,1351,0,19,19
987226,985829,1397,79,1318,0,19,20
957077,955704,1373,80,1293,0,19,20
951574,950452,1122,0,1122,0,19,19
930714,929653,1061,0,1061,0,19,19
921364,920244,1120,0,1120,0,19,19
899199,897843,1356,0,1356,0,19,19
882427,881312,1115,59,1056,0,19,20
869937,868909,1028,0,1028,0,19,19
844739,843409,1330,18,1312,0,19,20
1305074,1303589,1485,0,1485,0,19,19
1296251,1294655,1596,112,1484,0,19,20
1275226,1273866,1360,0,1360,0,19,19
1290490,1289024,1466,0,1466,0,19,19
1264700,1263131,1569,0,1569,0,19,19
1303682,1301706,1976,73,1903,0,19,20
1278498,1276909,1589,0,1589,0,19,19
1289378,1287580,1798,89,1709,0,19,20
1284458,1282669,1789,81,1708,0,19,20
1287261,1285304,1957,90,1867,0,19,20
1272823,1270710,2113,0,2041,72,20,20
1293050,1291471,1579,0,1579,0,19,19
1285912,1284161,1751,69,1682,0,19,20
1285254,1283531,1723,0,1723,0,19,19
1283545,1281988,1557,86,1471,0,19,20
1293371,1291851,1520,0,1520,0,19,19
