"POSITION","REF_CODON","CODON","REF_AA","AA","FWD_CNT","FWD_DENOM","REV_CNT","REV_DENOM","CNT","DENOM","std.bias","id"
36,"AAC","ACC","N","T",840,277149,8,449092,848,726241,9.0747775149433,347
37,"TAC","TCC","Y","S",10,278929,0,464953,10,743882,4.79875995242102,360
40,"GTA","GTC","V","V",33,212036,3,506351,36,718387,4.28255552209629,391
112,"TAC","GAC","Y","D",0,173964,10,135673,10,309637,4.80080286230377,1111
171,"GAA","GAC","E","D",44,129595,0,158879,44,288474,7.61365327973194,1687
178,"GTG","TTG","V","L",10,147813,0,149265,10,297078,4.80386197121915,1759
179,"GAA","GAC","E","D",18,144231,0,147537,18,291768,5.89152154344765,1762
215,"CTA","CGA","L","R",0,169970,65,150204,65,320174,8.37948857720264,2111
231,"AAC","ACC","N","T",45,187887,1,143358,46,331245,5.73388255936343,2267
247,"TGT","GGT","C","G",0,173567,8,166198,8,339765,4.40570243497906,2421
247,"TGT","TGG","C","W",0,173567,9,166198,9,339765,4.61429506504614,2426
273,"AAT","AAG","N","K",0,147836,11,180452,11,328288,4.58128556444972,2675
297,"CAG","CAT","Q","H",8,147369,85,147940,93,295309,4.51863452883223,2907
299,"TTC","TTA","F","L",11,147221,112,142172,123,289393,4.49540787348236,2926
305,"GTA","TTA","V","L",9,147466,148,136600,157,284066,5.40657249130367,2990
309,"CCA","CAA","P","Q",2,152286,22,136185,24,288471,4.08727789429324,3022
310,"GAG","GTG","E","V",0,150073,25,134926,25,284999,6.51738755424755,3041
313,"GAA","TAA","E",".",12,153591,273,137964,285,291555,6.09816508976595,3072
318,"CTG","CTT","L","L",10,164140,99,129921,109,294061,4.42208949165421,3121
321,"CTT","ATT","L","I",13,164865,221,128277,234,293142,5.52963620082771,3145
345,"GAA","GAC","E","D",40,175034,0,164277,40,339311,7.30111348262555,3385
357,"TAT","TAG","Y",".",0,175542,18,173168,18,348710,5.89156956973393,3502
382,"TAC","TAA","Y",".",0,171858,9,174776,9,346634,4.58202896913398,3746
466,"TCC","TCG","S","S",8,156961,0,154847,8,311808,4.37988842525807,4535
470,"TTT","TTA","F","L",9,149751,0,156206,9,305957,4.61431623952292,4574
511,"AGG","CGG","R","R",11,153048,0,150184,11,303232,4.93933958616554,4960
531,"ATA","AGA","I","R",0,156253,47,159231,47,315484,7.70592049997123,5146
589,"CAT","CAG","H","Q",0,600616,44,225394,44,826010,7.61339449344985,5722
599,"TTC","GTC","F","V",1,381863,35,505856,36,887719,5.22383682938433,5826
