coverage,wt.counts,mut.count,s.count,ns.count,stp.count,aa.sampled,codons.sampled
416143,415110,1033,0,1033,0,18,18
415319,414719,600,0,600,0,14,14
413324,412217,1107,0,1107,0,17,17
413896,413469,427,0,427,0,8,8
412159,411267,892,0,892,0,13,13
408764,408763,1,0,1,0,1,1
409854,407106,2748,0,2748,0,19,19
405148,402396,2752,0,2752,0,19,19
411781,408482,3299,0,3299,0,19,19
407260,402943,4317,0,4317,0,19,19
406132,403231,2901,0,2901,0,19,19
408645,405252,3393,152,3241,0,18,19
410794,407805,2989,0,2989,0,19,19
406142,403778,2364,0,2364,0,19,19
398916,397539,1377,0,1377,0,13,13
403444,401625,1819,0,1819,0,19,19
410230,408575,1655,0,1655,0,19,19
410290,408913,1377,0,1377,0,19,19
393012,390476,2536,0,2536,0,17,17
398061,397889,172,0,172,0,5,5
396738,394944,1794,118,1676,0,17,18
395592,394860,732,0,732,0,7,7
389444,387918,1526,0,1526,0,17,17
387129,386582,547,0,547,0,10,10
378703,377755,948,162,786,0,17,18
379126,379126,0,0,0,0,0,0
281640,280649,991,85,906,0,19,20
284291,283955,336,0,336,0,11,11
282557,281158,1399,0,1399,0,19,19
284378,283290,1088,68,1020,0,19,20
282814,281264,1550,0,1550,0,19,19
280732,280045,687,0,687,0,17,17
281231,280133,1098,0,1098,0,18,18
278306,277011,1295,0,1295,0,19,19
272090,270713,1377,0,1377,0,18,18
272186,271031,1155,0,1155,0,18,18
269771,269465,306,0,306,0,15,15
266772,265844,928,0,928,0,17,17
271488,270155,1333,0,1333,0,18,18
268796,267728,1068,53,1015,0,18,19
266282,264963,1319,0,1319,0,18,18
262704,261877,827,0,827,0,19,19
252061,251893,168,57,111,0,9,10
250592,250590,2,0,2,0,2,2
248206,247786,420,51,369,0,7,8
244802,244142,660,21,639,0,14,15
247833,247489,344,0,344,0,8,8
247297,246542,755,64,691,0,17,18
248592,247954,638,0,638,0,17,17
246376,245031,1345,0,1345,0,19,19
241804,240357,1447,0,1447,0,19,19
235099,233587,1512,0,1512,0,19,19
231841,230768,1073,0,1073,0,16,16
228325,227117,1208,0,1208,0,19,19
223641,221860,1781,0,1781,0,19,19
220769,219762,1007,0,1007,0,19,19
218519,216928,1591,0,1591,0,18,18
213798,212924,874,0,874,0,16,16
206193,205957,236,0,236,0,9,9
201447,200552,895,32,863,0,19,20
199785,199784,1,0,1,0,1,1
197143,196168,975,0,975,0,19,19
190984,190983,1,0,1,0,1,1
185394,184635,759,0,759,0,19,19
182613,181702,911,0,911,0,18,18
175313,175266,47,0,47,0,3,3
169300,168298,1002,0,1002,0,17,17
169153,169012,141,0,141,0,10,10
166743,166143,600,0,600,0,17,17
166592,166404,188,0,188,0,13,13
166333,165660,673,0,673,0,19,19
163876,163505,371,58,313,0,15,16
161445,160559,886,0,886,0,18,18
160224,159540,684,0,684,0,19,19
157989,157226,763,0,763,0,18,18
156161,155308,853,0,853,0,19,19
158763,157686,1077,0,1077,0,19,19
153574,152612,962,0,962,0,19,19
152742,152429,313,0,313,0,13,13
151129,150387,742,26,716,0,19,20
149547,149107,440,0,440,0,13,13
149177,148498,679,0,679,0,19,19
144381,143729,652,0,652,0,19,19
142889,142549,340,0,340,0,19,19
139906,139556,350,0,350,0,19,19
141015,140671,344,8,336,0,19,20
139756,139219,537,0,537,0,19,19
140709,140098,611,0,611,0,19,19
137503,137298,205,0,205,0,10,10
136610,136123,487,0,487,0,19,19
137799,137458,341,0,341,0,19,19
140151,140080,71,22,49,0,7,8
138576,138123,453,0,453,0,19,19
142973,142813,160,0,160,0,15,15
144911,144855,56,0,56,0,3,3
144460,144015,445,0,445,0,19,19
144993,144498,495,19,476,0,19,20
145529,145360,169,19,150,0,11,12
147486,147041,445,0,445,0,19,19
149216,149203,13,0,13,0,2,2
150617,150226,391,6,385,0,19,20
149393,149062,331,0,331,0,18,18
150806,150690,116,0,116,0,9,9
152625,152252,373,17,356,0,16,17
154607,153943,664,35,629,0,18,19
155296,155153,143,0,143,0,4,4
155079,154616,463,0,463,0,19,19
155911,155857,54,0,54,0,4,4
156803,156380,423,0,423,0,19,19
157220,157147,73,9,64,0,6,7
158144,157623,521,0,521,0,18,18
158639,158145,494,0,494,0,19,19
157649,157649,0,0,0,0,0,0
157775,157768,7,0,7,0,3,3
162380,162378,2,0,2,0,1,1
162918,162902,16,0,16,0,2,2
162242,161760,482,0,482,0,16,16
161611,160838,773,0,773,0,18,18
160265,160099,166,38,128,0,7,8
159879,159244,635,24,611,0,18,19
159376,159375,1,0,1,0,1,1
161108,160662,446,0,446,0,18,18
162331,162331,0,0,0,0,0,0
165064,165064,0,0,0,0,0,0
163305,162990,315,0,315,0,15,15
163185,162997,188,0,188,0,13,13
163620,163572,48,0,48,0,2,2
164083,163814,269,0,269,0,11,11
162720,162558,162,0,162,0,6,6
161668,161644,24,0,24,0,2,2
159699,159544,155,0,155,0,10,10
160786,160774,12,0,12,0,2,2
158513,158195,318,0,318,0,16,16
154545,154068,477,0,477,0,19,19
156372,155841,531,0,531,0,19,19
153275,152859,416,0,416,0,17,17
152252,152059,193,0,193,0,7,7
154776,154776,0,0,0,0,0,0
154968,154754,214,0,214,0,10,10
154229,153951,278,0,278,0,11,11
155486,155157,329,0,329,0,17,17
156589,156281,308,0,308,0,10,10
153607,153589,18,0,18,0,1,1
153616,153409,207,0,207,0,11,11
151537,151080,457,41,416,0,15,16
152201,151562,639,86,553,0,19,20
151352,151161,191,0,191,0,15,15
151404,151208,196,2,194,0,8,9
151831,151568,263,0,263,0,16,16
151623,151353,270,0,270,0,17,17
151304,151055,249,0,249,0,17,17
152503,152399,104,0,104,0,9,9
149735,149471,264,0,264,0,15,15
146248,145964,284,0,284,0,18,18
145541,145541,0,0,0,0,0,0
145358,145347,11,0,11,0,3,3
145052,145035,17,0,17,0,3,3
144366,144195,171,0,171,0,9,9
148429,148295,134,0,134,0,12,12
146933,146898,35,0,35,0,2,2
144589,144526,63,0,63,0,4,4
145658,145388,270,0,270,0,18,18
144874,144558,316,0,316,0,18,18
145677,145655,22,17,5,0,1,2
143620,143620,0,0,0,0,0,0
144739,144488,251,0,251,0,18,18
143300,143261,39,0,39,0,3,3
142804,142799,5,0,5,0,1,1
138820,138820,0,0,0,0,0,0
139268,138967,301,19,282,0,17,18
140437,140437,0,0,0,0,0,0
141839,141838,1,0,1,0,1,1
141930,141895,35,0,35,0,6,6
142355,141989,366,0,366,0,17,17
142087,141879,208,0,208,0,13,13
142680,142646,34,0,34,0,4,4
142320,142073,247,0,247,0,17,17
144681,144461,220,0,220,0,16,16
145131,145053,78,0,78,0,8,8
142549,142438,111,0,111,0,8,8
142371,141984,387,0,387,0,17,17
143446,143089,357,17,340,0,18,19
144269,144180,89,34,55,0,5,6
144161,143943,218,0,218,0,10,10
147035,146842,193,0,193,0,16,16
147620,147235,385,21,364,0,15,16
148341,148278,63,12,51,0,7,8
149729,149509,220,0,220,0,14,14
149312,149233,79,0,79,0,9,9
148832,148566,266,0,266,0,18,18
145101,144989,112,0,112,0,10,10
144929,144693,236,1,235,0,13,14
144566,144464,102,0,102,0,14,14
147219,147141,78,17,61,0,7,8
146852,146800,52,0,52,0,7,7
148703,148608,95,0,95,0,8,8
149158,149114,44,19,25,0,4,5
144819,144706,113,45,68,0,6,7
147309,147087,222,0,222,0,12,12
148456,148308,148,0,148,0,14,14
148089,147957,132,40,92,0,6,7
149084,148919,165,0,165,0,8,8
151408,151361,47,0,47,0,8,8
153358,153318,40,0,40,0,5,5
151080,150997,83,0,83,0,4,4
151119,151090,29,15,14,0,2,3
153469,153430,39,0,39,0,6,6
152848,152800,48,20,28,0,5,6
153352,153299,53,0,53,0,6,6
153999,153940,59,0,59,0,4,4
155771,155645,126,0,126,0,7,7
156109,156014,95,0,95,0,8,8
155747,155605,142,31,111,0,14,15
156085,155970,115,0,115,0,10,10
155612,155334,278,0,278,0,18,18
155230,155136,94,0,94,0,15,15
157334,157322,12,0,12,0,1,1
157054,156766,288,22,266,0,16,17
156833,156627,206,0,206,0,11,11
157444,157355,89,0,89,0,7,7
159352,159258,94,0,94,0,11,11
159504,159373,131,0,131,0,9,9
159972,159950,22,0,22,0,5,5
156968,156810,158,0,158,0,8,8
156799,156758,41,20,21,0,2,3
155810,155729,81,0,81,0,7,7
154742,154687,55,10,45,0,4,5
155765,155661,104,0,104,0,6,6
155549,155515,34,0,34,0,5,5
157353,157276,77,0,77,0,6,6
156975,156682,293,0,293,0,19,19
156651,156330,321,39,282,0,17,18
155030,155003,27,24,3,0,1,2
152689,152689,0,0,0,0,0,0
151799,151754,45,0,45,0,5,5
153680,153455,225,23,202,0,13,14
154679,154537,142,0,142,0,13,13
153703,153663,40,2,38,0,5,6
151769,151739,30,0,30,0,1,1
150825,150632,193,0,193,0,16,16
151052,151041,11,0,11,0,3,3
150966,150888,78,0,78,0,7,7
152506,152341,165,5,160,0,13,14
155478,155164,314,0,314,0,17,17
156507,156304,203,0,203,0,15,15
153342,153156,186,0,186,0,13,13
151194,150952,242,0,242,0,16,16
150278,150180,98,0,98,0,12,12
150378,150142,236,0,236,0,17,17
149330,149010,320,0,320,0,15,15
150060,149950,110,0,110,0,7,7
152303,152056,247,0,247,0,16,16
152886,152760,126,23,103,0,11,12
151915,151915,0,0,0,0,0,0
148931,148814,117,0,117,0,8,8
146828,146520,308,0,308,0,17,17
146018,145848,170,18,152,0,16,17
149112,149095,17,0,17,0,1,1
149468,149334,134,41,93,0,7,8
149445,149441,4,0,4,0,2,2
150608,150557,51,0,51,0,6,6
150633,150623,10,0,10,0,3,3
150166,150068,98,0,98,0,8,8
150494,150457,37,0,37,0,7,7
149309,149143,166,0,166,0,11,11
146646,146484,162,0,162,0,9,9
145975,145848,127,0,127,0,11,11
145721,145699,22,0,22,0,7,7
144643,144590,53,0,53,0,6,6
144072,144046,26,0,26,0,2,2
144130,144120,10,0,10,0,2,2
140086,139944,142,0,142,0,8,8
137662,137655,7,0,7,0,1,1
140676,140659,17,0,17,0,3,3
140512,140455,57,0,57,0,4,4
140930,140850,80,0,80,0,8,8
139874,139700,174,0,174,0,16,16
142367,142367,0,0,0,0,0,0
142460,142375,85,0,85,0,4,4
139101,138938,163,0,163,0,16,16
139325,139260,65,0,65,0,5,5
137927,137926,1,0,1,0,1,1
136095,136050,45,0,45,0,8,8
136932,136769,163,0,163,0,14,14
137865,137834,31,0,31,0,3,3
138121,138067,54,4,50,0,7,8
139185,139137,48,0,48,0,8,8
140113,139698,415,0,415,0,18,18
141397,141273,124,0,124,0,16,16
141054,140999,55,0,55,0,7,7
140652,140345,307,25,282,0,15,16
138516,138451,65,0,65,0,14,14
138306,138107,199,0,199,0,15,15
139188,139094,94,0,94,0,13,13
138796,138605,191,8,183,0,17,18
138951,138775,176,0,176,0,17,17
141410,141340,70,0,70,0,9,9
136977,136794,183,0,183,0,15,15
138965,138716,249,0,249,0,17,17
140780,140762,18,0,18,0,1,1
139232,139096,136,3,133,0,9,10
140868,140607,261,0,261,0,18,18
141682,141542,140,1,139,0,11,12
140904,140824,80,22,58,0,4,5
142547,142422,125,0,125,0,13,13
141601,141420,181,0,181,0,10,10
142736,142675,61,18,43,0,4,5
144422,144306,116,0,116,0,14,14
145605,145543,62,22,40,0,3,4
146484,146388,96,22,74,0,5,6
147392,147359,33,0,33,0,4,4
149952,149806,146,46,100,0,8,9
151541,151540,1,0,1,0,1,1
152794,152745,49,0,49,0,3,3
154215,153884,331,0,331,0,14,14
155507,155386,121,0,121,0,10,10
156539,156524,15,0,15,0,2,2
157007,156964,43,0,43,0,6,6
159147,159126,21,0,21,0,7,7
161670,161638,32,25,7,0,1,2
161227,161170,57,0,57,0,5,5
160075,160075,0,0,0,0,0,0
160653,160494,159,44,115,0,10,11
156797,156796,1,0,1,0,1,1
156205,155716,489,74,415,0,18,19
157859,157711,148,0,148,0,11,11
156894,156894,0,0,0,0,0,0
156484,156478,6,0,6,0,1,1
155686,155362,324,0,324,0,18,18
156742,156665,77,40,37,0,4,5
160907,160876,31,0,31,0,2,2
160258,159920,338,33,305,0,14,15
161552,161552,0,0,0,0,0,0
159766,159631,135,0,135,0,6,6
159790,159721,69,0,69,0,10,10
159529,159508,21,0,21,0,2,2
160842,160780,62,0,62,0,2,2
160355,160296,59,0,59,0,6,6
164646,164612,34,0,34,0,6,6
164245,164189,56,0,56,0,9,9
163073,162996,77,0,77,0,7,7
164631,164617,14,14,0,0,0,1
167513,167256,257,0,257,0,13,13
165444,165343,101,0,101,0,7,7
163948,163622,326,0,326,0,17,17
166528,166519,9,0,9,0,2,2
165596,165212,384,23,361,0,15,16
164590,164532,58,0,58,0,3,3
166758,166679,79,0,79,0,6,6
169917,169342,575,0,575,0,17,17
168222,168176,46,0,46,0,2,2
166411,166280,131,0,131,0,10,10
166201,166175,26,0,26,0,4,4
167703,167550,153,21,132,0,10,11
164077,163944,133,0,133,0,6,6
162917,162767,150,0,150,0,11,11
166124,165765,359,13,346,0,17,18
165572,165400,172,29,143,0,4,5
162525,162525,0,0,0,0,0,0
160639,160570,69,0,69,0,6,6
162861,162747,114,0,114,0,10,10
163905,163818,87,0,87,0,4,4
165323,164943,380,15,365,0,14,15
167893,167775,118,0,118,0,6,6
169258,169249,9,0,9,0,1,1
169175,169111,64,0,64,0,2,2
167745,167690,55,0,55,0,2,2
169192,169192,0,0,0,0,0,0
169219,169214,5,0,5,0,2,2
168644,168644,0,0,0,0,0,0
167854,167852,2,0,2,0,1,1
168021,167987,34,0,34,0,4,4
169532,169532,0,0,0,0,0,0
169875,169872,3,0,3,0,1,1
171333,171333,0,0,0,0,0,0
169348,169348,0,0,0,0,0,0
169440,169440,0,0,0,0,0,0
165811,165799,12,0,12,0,2,2
167344,167203,141,55,86,0,7,8
167232,167177,55,17,38,0,4,5
166472,166385,87,47,40,0,3,4
164158,164147,11,0,11,0,2,2
163303,163296,7,0,7,0,1,1
164302,163863,439,45,394,0,14,15
165056,165056,0,0,0,0,0,0
165201,165201,0,0,0,0,0,0
163887,163735,152,0,152,0,10,10
160070,160070,0,0,0,0,0,0
159199,159197,2,0,2,0,1,1
160313,160284,29,29,0,0,0,1
159634,159601,33,0,33,0,4,4
159127,159068,59,0,59,0,4,4
160101,160101,0,0,0,0,0,0
159880,159623,257,0,257,0,11,11
157712,157568,144,30,114,0,4,5
155040,154917,123,0,123,0,5,5
152935,152933,2,0,2,0,1,1
153672,153585,87,78,9,0,2,3
153491,153218,273,33,240,0,11,12
153725,153681,44,23,21,0,2,3
155219,155123,96,0,96,0,3,3
156614,156060,554,0,554,0,15,15
156416,156303,113,0,113,0,8,8
154942,154718,224,71,153,0,8,9
154572,154370,202,0,202,0,12,12
157266,157206,60,15,45,0,5,6
158875,158717,158,35,123,0,8,9
159003,158796,207,0,207,0,10,10
161252,161252,0,0,0,0,0,0
161639,161605,34,18,16,0,1,2
163103,163038,65,53,12,0,1,2
160884,160883,1,0,1,0,1,1
161261,161261,0,0,0,0,0,0
162413,162413,0,0,0,0,0,0
161357,161351,6,0,6,0,1,1
161619,161219,400,0,400,0,16,16
163227,163218,9,0,9,0,2,2
164280,164270,10,0,10,0,1,1
166948,166947,1,0,1,0,1,1
166378,166293,85,0,85,0,4,4
165676,165675,1,0,1,0,1,1
164764,164735,29,0,29,0,1,1
164595,164492,103,0,103,0,9,9
164684,164670,14,0,14,0,4,4
163948,163698,250,0,250,0,12,12
164292,164236,56,0,56,0,4,4
163902,163730,172,0,172,0,6,6
166255,166227,28,0,28,0,1,1
163372,163336,36,0,36,0,3,3
164372,164369,3,0,3,0,1,1
163757,163757,0,0,0,0,0,0
162879,162837,42,42,0,0,0,1
161276,161231,45,0,45,0,5,5
159400,159399,1,0,1,0,1,1
158457,158457,0,0,0,0,0,0
157809,157809,0,0,0,0,0,0
155580,155557,23,0,23,0,1,1
157569,157563,6,0,6,0,1,1
157180,156927,253,0,253,0,12,12
152978,152978,0,0,0,0,0,0
150710,150668,42,0,42,0,1,1
151093,151006,87,45,42,0,2,3
152842,152694,148,36,112,0,8,9
151868,151849,19,0,19,0,2,2
151471,151471,0,0,0,0,0,0
152413,152413,0,0,0,0,0,0
153280,153268,12,0,12,0,1,1
151421,151419,2,0,2,0,1,1
150893,150874,19,19,0,0,0,1
153170,153051,119,72,47,0,2,3
154109,154109,0,0,0,0,0,0
153717,153698,19,0,19,0,2,2
153088,153088,0,0,0,0,0,0
152020,151919,101,0,101,0,11,11
150762,150725,37,0,37,0,4,4
152096,152096,0,0,0,0,0,0
146426,146413,13,0,13,0,1,1
146971,146971,0,0,0,0,0,0
146873,146760,113,0,113,0,8,8
147310,147247,63,18,45,0,1,2
147488,147473,15,0,15,0,1,1
147042,146998,44,0,44,0,5,5
145525,145523,2,0,2,0,1,1
146462,146462,0,0,0,0,0,0
148944,148711,233,0,233,0,15,15
150533,150328,205,50,155,0,12,13
152303,152301,2,0,2,0,1,1
150349,150165,184,0,184,0,12,12
151134,151088,46,30,16,0,2,3
148430,148099,331,0,331,0,15,15
148781,148735,46,0,46,0,3,3
148847,148752,95,0,95,0,4,4
150456,150316,140,56,84,0,6,7
150787,150766,21,0,21,0,1,1
149989,149934,55,55,0,0,0,1
149388,149388,0,0,0,0,0,0
147462,147460,2,0,2,0,1,1
146515,146338,177,0,177,0,8,8
146412,146373,39,0,39,0,7,7
147587,147514,73,48,25,0,4,5
147511,147489,22,0,22,0,2,2
148230,148115,115,0,115,0,4,4
149194,149149,45,0,45,0,1,1
148691,148629,62,0,62,0,2,2
147759,147759,0,0,0,0,0,0
146943,146918,25,0,25,0,3,3
147297,147249,48,39,9,0,2,3
148910,148910,0,0,0,0,0,0
145397,145313,84,56,28,0,4,5
145861,145759,102,102,0,0,0,1
144456,144456,0,0,0,0,0,0
143274,143215,59,51,8,0,2,3
142453,142334,119,0,119,0,7,7
142826,142759,67,64,3,0,1,2
143004,142940,64,64,0,0,0,1
144213,144181,32,0,32,0,1,1
143284,143122,162,0,162,0,14,14
145493,145457,36,0,36,0,5,5
145141,145140,1,0,1,0,1,1
143678,143535,143,0,143,0,9,9
143001,142994,7,0,7,0,2,2
141628,141584,44,0,44,0,3,3
141996,141996,0,0,0,0,0,0
143573,143413,160,0,160,0,11,11
143705,143412,293,0,293,0,9,9
145498,145274,224,43,181,0,11,12
148501,148020,481,0,481,0,15,15
146836,146783,53,0,53,0,2,2
147598,147153,445,33,412,0,15,16
149095,148665,430,0,430,0,16,16
149864,149145,719,0,719,0,15,15
151154,150887,267,0,267,0,11,11
153428,153281,147,0,147,0,8,8
159695,159451,244,0,244,0,5,5
161354,160849,505,0,505,0,16,16
161820,161710,110,0,110,0,4,4
168589,168387,202,0,202,0,12,12
170722,169922,800,0,800,0,19,19
174108,173917,191,33,158,0,5,6
174738,174640,98,0,98,0,4,4
177565,176701,864,0,864,0,19,19
180747,179878,869,0,869,0,19,19
180777,180775,2,0,2,0,1,1
181560,181340,220,0,220,0,13,13
192284,191720,564,0,564,0,17,17
192157,191960,197,0,197,0,6,6
189908,189857,51,0,51,0,4,4
191551,190954,597,0,597,0,16,16
194958,194826,132,0,132,0,9,9
199321,198958,363,0,363,0,12,12
199577,199565,12,0,12,0,2,2
203353,203313,40,0,40,0,1,1
207961,207837,124,0,124,0,4,4
210890,210622,268,0,268,0,14,14
214948,214948,0,0,0,0,0,0
213672,213403,269,0,269,0,7,7
217520,217438,82,0,82,0,4,4
220003,219778,225,60,165,0,5,6
220167,220037,130,0,130,0,4,4
229723,229673,50,0,50,0,2,2
246843,246827,16,0,16,0,1,1
250746,250561,185,0,185,0,8,8
251503,251425,78,0,78,0,2,2
248805,248464,341,0,341,0,9,9
251599,251599,0,0,0,0,0,0
256426,256105,321,0,321,0,6,6
259851,259674,177,0,177,0,13,13
264172,263955,217,0,217,0,6,6
267387,267101,286,251,35,0,1,2
266390,265998,392,60,332,0,13,14
267379,266819,560,0,560,0,17,17
268380,268075,305,0,305,0,6,6
271260,270704,556,0,556,0,13,13
276415,276273,142,142,0,0,0,1
281386,280800,586,0,586,0,12,12
282437,282149,288,134,154,0,5,6
279829,279479,350,85,265,0,5,6
285319,285319,0,0,0,0,0,0
290415,290188,227,0,227,0,10,10
293254,292963,291,74,217,0,5,6
295388,295133,255,0,255,0,4,4
296591,296278,313,0,313,0,9,9
295923,295804,119,0,119,0,1,1
288515,287854,661,0,661,0,6,6
290031,289017,1014,0,1014,0,16,16
295805,294928,877,214,663,0,16,17
302488,302197,291,0,291,0,10,10
299766,299439,327,0,327,0,6,6
405727,403973,1754,0,1754,0,18,18
407961,407536,425,0,425,0,15,15
408467,408357,110,110,0,0,0,1
412129,411772,357,0,357,0,13,13
419252,417531,1721,99,1622,0,18,19
406008,405833,175,0,175,0,4,4
425049,424338,711,0,711,0,13,13
423782,422442,1340,0,1340,0,15,15
421958,420891,1067,0,1067,0,17,17
423432,423208,224,134,90,0,2,3
427098,426626,472,0,472,0,11,11
420672,420467,205,0,205,0,5,5
423844,423536,308,246,62,0,2,3
425790,425790,0,0,0,0,0,0
422712,422712,0,0,0,0,0,0
421686,421610,76,0,76,0,2,2
424919,423724,1195,0,1195,0,17,17
421633,420254,1379,0,1379,0,18,18
420610,418269,2341,0,2341,0,19,19
428717,428253,464,0,464,0,2,2
