coverage,wt.counts,mut.count,s.count,ns.count,stp.count,aa.sampled,codons.sampled
999386,997620,1766,0,1766,0,19,19
998342,997732,610,0,610,0,17,17
994218,992700,1518,0,1518,0,17,17
996510,996264,246,0,246,0,13,13
992970,991522,1448,0,1448,0,16,16
986742,986732,10,0,10,0,3,3
988410,985490,2920,0,2920,0,19,19
977809,973703,4106,0,4106,0,19,19
991755,988158,3597,0,3597,0,19,19
981895,978877,3018,0,3018,0,19,19
978566,975385,3181,0,3181,0,19,19
983426,980436,2990,306,2684,0,19,20
989846,986029,3817,0,3817,0,19,19
977791,975258,2533,0,2533,0,19,19
962181,960976,1205,0,1205,0,18,18
971974,970170,1804,0,1804,0,19,19
987404,985771,1633,0,1633,0,19,19
987819,986150,1669,0,1669,0,19,19
945817,943404,2413,0,2413,0,17,17
962240,962119,121,0,121,0,4,4
960633,958380,2253,201,2052,0,17,18
960231,959399,832,0,832,0,10,10
945739,944200,1539,0,1539,0,17,17
944280,943769,511,0,511,0,12,12
926763,925720,1043,125,918,0,16,17
928383,928369,14,0,14,0,1,1
618906,617509,1397,90,1307,0,18,19
629701,629388,313,0,313,0,16,16
627233,625909,1324,0,1324,0,19,19
633551,631942,1609,99,1510,0,19,20
631144,629644,1500,0,1500,0,19,19
628896,628277,619,0,619,0,16,16
630507,628783,1724,0,1724,0,18,18
625666,624117,1549,0,1549,0,19,19
612692,611304,1388,0,1388,0,19,19
614583,613133,1450,0,1450,0,19,19
610865,610389,476,0,476,0,15,15
605743,605250,493,0,493,0,18,18
619976,618780,1196,0,1196,0,19,19
616154,614989,1165,43,1122,0,18,19
612545,610502,2043,0,2043,0,19,19
607755,606278,1477,0,1477,0,19,19
586241,586059,182,80,102,0,13,14
587007,586998,9,0,9,0,3,3
582558,582158,400,105,295,0,6,7
582040,581307,733,51,682,0,14,15
584435,584190,245,0,245,0,7,7
585271,584361,910,24,886,0,17,18
590116,589318,798,0,798,0,17,17
588544,587153,1391,0,1391,0,19,19
580189,578290,1899,0,1899,0,19,19
567040,565573,1467,0,1467,0,19,19
560555,559284,1271,0,1271,0,18,18
556197,555041,1156,0,1156,0,19,19
547689,545837,1852,0,1852,0,19,19
543640,542606,1034,0,1034,0,19,19
540576,537855,2721,0,2721,0,19,19
529711,528714,997,0,997,0,16,16
512708,512477,231,0,231,0,11,11
502536,501562,974,39,935,0,19,20
500286,500286,0,0,0,0,0,0
496332,495006,1326,0,1326,0,19,19
485572,485569,3,0,3,0,2,2
473075,471535,1540,0,1540,0,19,19
468495,467129,1366,0,1366,0,18,18
451971,451834,137,0,137,0,3,3
439191,438259,932,0,932,0,17,17
439019,438884,135,0,135,0,9,9
432057,431470,587,0,587,0,19,19
432831,432443,388,0,388,0,11,11
431733,430925,808,0,808,0,19,19
426540,426105,435,10,425,0,17,18
421503,419996,1507,0,1507,0,18,18
418917,417891,1026,0,1026,0,19,19
412798,411547,1251,0,1251,0,18,18
409050,407523,1527,0,1527,0,19,19
414944,413761,1183,0,1183,0,19,19
400002,398856,1146,0,1146,0,19,19
396157,395792,365,0,365,0,14,14
391044,390172,872,25,847,0,19,20
384554,384074,480,0,480,0,15,15
382931,381929,1002,0,1002,0,19,19
368822,367899,923,0,923,0,19,19
363431,362941,490,0,490,0,19,19
355199,354440,759,0,759,0,19,19
356309,355533,776,45,731,0,19,20
350720,349812,908,0,908,0,19,19
350378,349411,967,0,967,0,19,19
339858,339449,409,0,409,0,12,12
335155,334458,697,0,697,0,19,19
336443,335280,1163,0,1163,0,19,19
340868,340588,280,55,225,0,10,11
334951,334077,874,0,874,0,19,19
342923,342613,310,0,310,0,19,19
345239,345185,54,0,54,0,6,6
342025,341175,850,0,850,0,19,19
342086,341055,1031,53,978,0,19,20
342414,342000,414,73,341,0,16,17
344286,343454,832,0,831,1,20,20
346909,346886,23,0,23,0,6,6
347308,346679,629,14,615,0,18,19
341010,340484,526,0,526,0,18,18
341791,341504,287,0,287,0,9,9
344233,343795,438,17,421,0,17,18
346628,345741,887,45,842,0,19,20
345407,345181,226,0,226,0,7,7
343529,342532,997,0,997,0,19,19
344538,344363,175,0,175,0,11,11
344525,343459,1066,0,1066,0,19,19
344073,343816,257,37,220,0,9,10
344678,343741,937,0,937,0,18,18
345569,344768,801,0,801,0,19,19
342745,342743,2,0,2,0,1,1
341972,341938,34,0,34,0,7,7
352098,352094,4,0,4,0,2,2
351487,351457,30,0,30,0,3,3
349396,348760,636,0,636,0,18,18
346659,345550,1109,0,1109,0,19,19
343507,343237,270,42,228,0,8,9
341718,340794,924,46,878,0,17,18
340092,340089,3,0,3,0,1,1
342631,341811,820,0,820,0,19,19
344756,344751,5,0,5,0,2,2
350467,350467,0,0,0,0,0,0
346072,345694,378,0,378,0,17,17
345127,344902,225,0,225,0,14,14
344448,344362,86,0,86,0,1,1
345451,345136,315,0,315,0,13,13
342471,342286,185,0,185,0,10,10
339336,339253,83,0,83,0,6,6
336092,335699,393,0,393,0,10,10
337228,337199,29,0,29,0,3,3
331377,330930,447,0,447,0,17,17
322164,321299,865,0,865,0,19,19
326234,325484,750,0,750,0,19,19
319736,318925,811,0,811,0,18,18
317392,317163,229,0,229,0,9,9
323186,323178,8,0,8,0,3,3
323460,323285,175,0,175,0,10,10
320819,320453,366,0,366,0,11,11
324727,324270,457,0,457,0,17,17
326651,326162,489,0,489,0,10,10
320059,319981,78,58,20,0,3,4
320242,319972,270,0,270,0,15,15
315827,315233,594,44,550,0,18,19
316548,315732,816,13,803,0,19,20
315357,315046,311,0,311,0,15,15
315384,315138,246,13,233,0,7,8
315225,314867,358,0,358,0,16,16
315861,315339,522,0,522,0,19,19
315223,314847,376,0,376,0,19,19
318242,317924,318,0,318,0,9,9
313137,312797,340,0,340,0,15,15
304956,304366,590,0,590,0,17,17
304074,304074,0,0,0,0,0,0
304896,304845,51,0,51,0,7,7
304830,304757,73,0,73,0,7,7
303526,303222,304,0,304,0,12,12
313805,313552,253,0,253,0,14,14
311392,311284,108,0,108,0,2,2
306313,306190,123,0,123,0,5,5
308707,308192,515,0,515,0,18,18
307119,306563,556,0,556,0,18,18
309150,309114,36,27,9,0,1,2
305722,305722,0,0,0,0,0,0
307987,307641,346,0,346,0,18,18
304040,303939,101,0,101,0,3,3
303982,303968,14,0,14,0,2,2
295679,295674,5,0,5,0,1,1
296817,296210,607,39,568,0,17,18
299903,299903,0,0,0,0,0,0
301988,301985,3,0,3,0,2,2
303838,303759,79,0,79,0,7,7
304998,304407,591,0,591,0,17,17
304443,304095,348,0,348,0,13,13
305872,305767,105,0,105,0,3,3
304673,304069,604,0,604,0,17,17
309746,309282,464,0,464,0,18,18
310333,310178,155,0,155,0,8,8
304540,304382,158,0,158,0,9,9
303723,303150,573,0,573,0,17,17
306115,305490,625,46,579,0,18,19
307950,307779,171,59,112,0,5,6
307129,306818,311,0,311,0,9,9
313995,313608,387,0,387,0,17,17
315589,314936,653,50,603,0,18,19
317059,316916,143,24,119,0,5,6
321020,320520,500,0,500,0,17,17
319710,319536,174,0,174,0,12,12
318498,318179,319,0,319,0,16,16
310540,310371,169,0,169,0,13,13
310053,309510,543,4,539,0,14,15
309689,309343,346,0,346,0,15,15
315017,314865,152,26,126,0,11,12
314394,314274,120,0,120,0,11,11
318370,318275,95,0,95,0,9,9
319009,318952,57,3,54,0,5,6
313092,312960,132,43,89,0,6,7
314188,313885,303,0,303,0,14,14
316424,316138,286,0,286,0,15,15
315369,315152,217,70,147,0,6,7
317942,317756,186,0,186,0,9,9
323523,323459,64,0,64,0,9,9
326525,326393,132,0,132,0,6,6
320907,320740,167,0,167,0,5,5
320650,320604,46,10,36,0,5,6
325690,325634,56,0,56,0,9,9
323773,323661,112,12,100,0,5,6
324540,324436,104,0,104,0,6,6
325034,324951,83,0,83,0,4,4
329155,328986,169,0,169,0,7,7
328990,328826,164,0,164,0,10,10
327692,327507,185,12,173,0,15,16
327728,327446,282,0,282,0,13,13
326951,326506,445,0,445,0,19,19
326579,326300,279,0,279,0,18,18
330923,330879,44,0,44,0,3,3
331010,330554,456,27,429,0,17,18
330750,330362,388,0,388,0,13,13
331904,331712,192,0,192,0,8,8
336074,335816,258,0,258,0,10,10
336744,336558,186,0,186,0,11,11
337525,337496,29,0,29,0,4,4
330846,330624,222,0,222,0,9,9
330890,330700,190,106,84,0,6,7
328490,328345,145,0,145,0,10,10
325382,325257,125,51,74,0,6,7
327871,327729,142,0,142,0,7,7
328689,328652,37,0,37,0,7,7
332424,332307,117,0,117,0,9,9
331231,330655,576,0,576,0,19,19
330993,330510,483,3,480,0,18,19
327382,327314,68,57,11,0,2,3
321921,321921,0,0,0,0,0,0
320122,320027,95,0,95,0,8,8
323928,323490,438,62,376,0,14,15
327153,326927,226,0,226,0,14,14
325559,325466,93,22,71,0,5,6
321136,321100,36,0,36,0,2,2
319931,319428,503,0,503,0,18,18
321029,320985,44,0,44,0,8,8
321179,321081,98,0,98,0,7,7
324766,324548,218,8,210,0,14,15
331461,331035,426,0,426,0,18,18
333508,332999,509,0,509,0,15,15
326189,325868,321,0,321,0,13,13
323155,322781,374,0,374,0,17,17
321367,321081,286,0,286,0,16,16
322160,321592,568,0,568,0,19,19
319377,318687,690,0,690,0,17,17
320920,320800,120,0,120,0,7,7
326431,325759,672,0,672,0,18,18
327778,327492,286,37,249,0,13,14
326616,326615,1,0,1,0,1,1
320131,319878,253,0,253,0,12,12
316090,315508,582,0,582,0,16,16
314043,313551,492,27,465,0,18,19
321623,321592,31,0,31,0,1,1
322457,322113,344,31,313,0,13,14
322009,321992,17,0,17,0,2,2
324277,324169,108,0,108,0,10,10
325306,325271,35,0,35,0,4,4
324064,323833,231,0,231,0,13,13
325693,325578,115,0,115,0,10,10
323383,323069,314,0,314,0,12,12
318154,317938,216,0,216,0,11,11
317196,316920,276,0,276,0,12,12
315989,315938,51,0,51,0,8,8
314310,314166,144,0,144,0,10,10
314399,314357,42,0,42,0,2,2
314581,314556,25,0,25,0,4,4
307383,307174,209,0,209,0,9,9
302759,302746,13,0,13,0,1,1
308972,308896,76,0,76,0,3,3
308124,307985,139,0,139,0,4,4
307465,307343,122,0,122,0,9,9
307325,306908,417,0,417,0,17,17
311858,311858,0,0,0,0,0,0
311234,311093,141,0,141,0,6,6
305011,304589,422,0,422,0,17,17
305171,305085,86,0,86,0,7,7
302973,302965,8,0,8,0,4,4
299200,298932,268,0,268,0,11,11
301877,301537,340,0,340,0,16,16
303613,303560,53,0,53,0,3,3
305811,305663,148,40,108,0,7,8
306145,306005,140,0,140,0,10,10
309288,308455,833,0,833,0,18,18
310774,310372,402,0,402,0,17,17
310146,310024,122,0,122,0,10,10
309245,308585,660,27,633,0,18,19
304003,303806,197,0,197,0,19,19
304957,304444,513,0,513,0,18,18
306950,306638,312,0,312,0,14,14
305609,305256,353,24,329,0,17,18
307887,307348,539,0,539,0,18,18
310015,309915,100,0,100,0,12,12
300811,300565,246,0,246,0,16,16
306061,305428,633,0,633,0,18,18
309478,309436,42,0,42,0,2,2
306787,306536,251,15,236,0,11,12
309278,308699,579,0,579,0,18,18
311771,311410,361,41,320,0,17,18
309415,309278,137,21,116,0,6,7
312643,312428,215,0,215,0,16,16
310465,310168,297,0,297,0,13,13
311982,311866,116,43,73,0,3,4
315201,314975,226,0,226,0,15,15
317252,317153,99,50,49,0,2,3
318273,318039,234,58,176,0,8,9
319391,319320,71,0,71,0,6,6
324381,324043,338,57,281,0,13,14
327079,327072,7,0,7,0,2,2
330067,329913,154,0,154,0,5,5
332942,332369,573,0,573,0,15,15
336386,336054,332,0,332,0,12,12
337765,337714,51,0,51,0,3,3
338327,338231,96,0,96,0,11,11
342917,342796,121,0,121,0,13,13
348256,348197,59,35,24,0,2,3
346817,346667,150,0,150,0,11,11
344443,344443,0,0,0,0,0,0
345526,345327,199,79,120,0,11,12
338205,338203,2,0,2,0,1,1
336834,336266,568,75,493,0,19,20
340385,340196,189,0,189,0,11,11
338948,338943,5,0,5,0,4,4
338409,338402,7,0,7,0,1,1
335974,335614,360,0,360,0,17,17
337977,337872,105,74,31,0,3,4
346474,346443,31,0,31,0,2,2
345795,345402,393,36,357,0,14,15
347997,347995,2,0,2,0,1,1
344349,344200,149,0,149,0,6,6
343581,343457,124,0,124,0,16,16
343151,343105,46,0,46,0,3,3
346377,346278,99,0,99,0,3,3
344511,344385,126,0,126,0,6,6
352935,352873,62,0,62,0,7,7
351700,351616,84,0,84,0,11,11
348951,348791,160,0,160,0,7,7
352415,352379,36,35,1,0,1,2
358001,357730,271,0,271,0,13,13
353146,352989,157,0,157,0,8,8
350066,349811,255,0,255,0,16,16
356349,356345,4,0,4,0,1,1
354666,354273,393,53,340,0,15,16
351877,351821,56,0,56,0,3,3
356725,356633,92,0,92,0,5,5
363803,363186,617,0,617,0,17,17
359392,359378,14,0,14,0,1,1
355889,355710,179,0,179,0,12,12
355674,355632,42,0,42,0,2,2
358969,358660,309,65,244,0,12,13
350771,350631,140,0,140,0,5,5
348339,348196,143,0,143,0,12,12
355485,354656,829,43,786,0,18,19
354454,354213,241,55,186,0,7,8
348182,348181,1,0,1,0,1,1
342607,342572,35,0,35,0,8,8
346819,346678,141,0,141,0,11,11
350491,350331,160,0,160,0,5,5
353793,353261,532,80,452,0,16,17
359777,359633,144,0,144,0,9,9
361778,361740,38,0,38,0,2,2
361633,361600,33,0,33,0,2,2
358243,358215,28,0,28,0,3,3
360847,360847,0,0,0,0,0,0
359785,359772,13,0,13,0,2,2
358152,358152,0,0,0,0,0,0
356181,356181,0,0,0,0,0,0
356264,356237,27,0,27,0,4,4
359616,359616,0,0,0,0,0,0
360910,360909,1,0,1,0,1,1
364062,364062,0,0,0,0,0,0
359258,359258,0,0,0,0,0,0
359256,359255,1,0,1,0,1,1
350795,350792,3,0,3,0,3,3
353959,353733,226,39,187,0,7,8
353249,353159,90,31,59,0,3,4
351179,351062,117,44,73,0,3,4
345769,345743,26,0,26,0,2,2
344459,344445,14,0,14,0,1,1
346029,345527,502,56,446,0,15,16
347671,347671,0,0,0,0,0,0
348434,348433,1,0,1,0,1,1
345116,344835,281,0,281,0,12,12
336961,336961,0,0,0,0,0,0
335330,335325,5,0,5,0,2,2
337889,337843,46,45,1,0,1,2
337038,336966,72,0,72,0,4,4
335291,335239,52,0,52,0,4,4
338979,338979,0,0,0,0,0,0
338744,338469,275,0,275,0,10,10
334636,334385,251,70,181,0,5,6
329418,329350,68,0,68,0,5,5
323922,323922,0,0,0,0,0,0
324761,324686,75,52,23,0,2,3
323915,323542,373,62,311,0,12,13
324781,324690,91,46,45,0,3,4
327628,327475,153,0,153,0,3,3
330938,330331,607,0,607,0,16,16
330409,330321,88,0,88,0,11,11
326915,326648,267,33,234,0,7,8
326918,326653,265,0,265,0,15,15
333612,333567,45,14,31,0,4,5
337674,337547,127,27,100,0,9,10
338114,337927,187,0,187,0,12,12
342371,342371,0,0,0,0,0,0
343328,343246,82,67,15,0,1,2
346247,346192,55,44,11,0,2,3
340371,340371,0,0,0,0,0,0
341184,341184,0,0,0,0,0,0
343168,343168,0,0,0,0,0,0
341377,341377,0,0,0,0,0,0
341956,341457,499,0,499,0,16,16
345732,345715,17,0,17,0,2,2
348227,348203,24,0,24,0,1,1
354444,354439,5,0,5,0,1,1
353693,353659,34,0,34,0,5,5
352877,352876,1,0,1,0,1,1
350788,350781,7,0,7,0,2,2
349225,349091,134,0,134,0,10,10
348902,348856,46,0,46,0,2,2
347318,347038,280,0,280,0,12,12
348885,348766,119,0,119,0,4,4
348224,348009,215,0,215,0,6,6
352476,352447,29,0,29,0,2,2
347178,347158,20,0,20,0,3,3
348725,348721,4,0,4,0,1,1
348527,348524,3,0,3,0,1,1
345710,345645,65,65,0,0,0,1
341277,341159,118,0,118,0,7,7
338225,338225,0,0,0,0,0,0
335534,335533,1,0,1,0,1,1
333702,333702,0,0,0,0,0,0
329039,329025,14,0,14,0,2,2
334245,334229,16,0,16,0,1,1
333214,332978,236,0,236,0,11,11
323545,323545,0,0,0,0,0,0
319122,319096,26,0,26,0,3,3
320128,320082,46,22,24,0,2,3
323335,323205,130,59,71,0,5,6
320812,320804,8,0,8,0,2,2
319732,319730,2,0,2,0,1,1
321359,321358,1,0,1,0,1,1
322717,322708,9,0,9,0,2,2
318952,318948,4,0,4,0,1,1
318033,317999,34,34,0,0,0,1
322565,322473,92,28,64,0,3,4
323888,323888,0,0,0,0,0,0
323139,323097,42,0,42,0,3,3
321463,321458,5,0,5,0,2,2
319822,319604,218,0,218,0,12,12
317341,317272,69,0,69,0,4,4
320160,320160,0,0,0,0,0,0
307416,307398,18,0,18,0,1,1
307546,307546,0,0,0,0,0,0
308010,307920,90,0,90,0,10,10
309060,308984,76,47,29,0,2,3
309678,309652,26,0,26,0,3,3
309732,309690,42,0,42,0,5,5
305898,305896,2,0,2,0,1,1
308100,308100,0,0,0,0,0,0
313172,312989,183,0,183,0,14,14
316176,315784,392,104,288,0,14,15
319895,319893,2,0,2,0,1,1
316056,315863,193,0,193,0,12,12
317214,317172,42,24,18,0,2,3
310956,310634,322,0,322,0,14,14
312036,311943,93,0,93,0,3,3
312590,312516,74,0,74,0,4,4
316456,316235,221,94,127,0,4,5
316974,316941,33,0,33,0,2,2
316039,315955,84,84,0,0,0,1
315637,315637,0,0,0,0,0,0
311749,311748,1,0,1,0,1,1
310179,309938,241,0,241,0,8,8
310972,310929,43,0,43,0,6,6
314286,314211,75,28,47,0,5,6
315202,315171,31,0,31,0,2,2
317171,317136,35,0,35,0,6,6
320030,319998,32,0,32,0,1,1
319606,319525,81,0,81,0,3,3
318185,318185,0,0,0,0,0,0
317307,317183,124,0,124,0,2,2
319534,319492,42,42,0,0,0,1
325126,325125,1,0,1,0,1,1
318222,318153,69,23,46,0,5,6
320084,320048,36,34,2,0,1,2
318122,318122,0,0,0,0,0,0
316997,316937,60,37,23,0,3,4
316793,316654,139,0,139,0,10,10
325599,325504,95,77,18,0,2,3
321970,321914,56,56,0,0,0,1
325950,325892,58,0,58,0,1,1
326440,326234,206,0,206,0,14,14
333604,333487,117,0,117,0,7,7
335400,335399,1,0,1,0,1,1
332984,332847,137,0,137,0,9,9
332887,332885,2,0,2,0,2,2
331299,331258,41,0,41,0,4,4
332562,332558,4,0,4,0,1,1
337015,336804,211,0,211,0,10,10
339361,339067,294,0,294,0,9,9
344793,344600,193,67,126,0,11,12
353722,352988,734,0,734,0,14,14
351008,350909,99,0,99,0,2,2
353291,352947,344,63,281,0,15,16
357344,356512,832,0,832,0,17,17
360003,359299,704,0,704,0,17,17
362498,362292,206,0,206,0,12,12
368917,368712,205,0,205,0,9,9
385241,384935,306,0,306,0,7,7
389481,389045,436,0,436,0,16,16
391164,391012,152,0,152,0,5,5
407553,407138,415,0,415,0,15,15
412153,411290,863,0,863,0,17,17
419532,419186,346,78,268,0,7,8
421264,421206,58,0,58,0,5,5
427772,426712,1060,0,1060,0,19,19
435171,434074,1097,0,1097,0,19,19
435281,435278,3,0,3,0,1,1
437714,437530,184,0,184,0,15,15
463625,463193,432,0,432,0,17,17
462281,462198,83,0,83,0,8,8
456799,456780,19,0,19,0,4,4
459160,458346,814,0,814,0,16,16
465404,465235,169,0,169,0,8,8
473620,473240,380,0,380,0,13,13
474050,474049,1,0,1,0,1,1
481356,481310,46,0,46,0,1,1
491080,491018,62,0,62,0,4,4
495198,495007,191,0,191,0,13,13
502638,502636,2,0,2,0,1,1
499136,498761,375,0,375,0,8,8
507420,507353,67,0,67,0,4,4
512216,511997,219,76,143,0,5,6
512459,512350,109,0,109,0,4,4
533261,533221,40,0,40,0,2,2
570263,570235,28,0,28,0,1,1
577448,577349,99,0,99,0,6,6
576924,576842,82,0,82,0,2,2
570617,570160,457,0,457,0,10,10
575777,575772,5,0,5,0,1,1
585366,585229,137,0,137,0,6,6
592180,591892,288,0,288,0,13,13
601138,600914,224,0,224,0,6,6
607992,607912,80,34,46,0,1,2
604669,604287,382,113,269,0,14,15
606550,605877,673,0,673,0,18,18
606876,606746,130,0,130,0,6,6
611660,611209,451,0,451,0,14,14
623454,623395,59,59,0,0,0,1
635130,634650,480,0,480,0,12,12
636213,635958,255,127,128,0,6,7
630630,630257,373,81,292,0,7,8
642407,642406,1,0,1,0,1,1
652411,651982,429,0,429,0,9,9
657423,657114,309,54,255,0,5,6
661516,661318,198,0,198,0,5,5
663066,662553,513,0,513,0,10,10
660341,660216,125,0,125,0,2,2
640913,640454,459,0,459,0,6,6
642679,641556,1123,0,1123,0,16,16
655477,654548,929,233,696,0,16,17
668489,668221,268,0,268,0,11,11
661728,661375,353,0,353,0,7,7
959983,957290,2693,0,2693,0,18,18
963195,962181,1014,0,1014,0,15,15
964985,964749,236,229,7,0,1,2
970834,970297,537,0,537,0,15,15
986742,984205,2537,265,2272,0,18,19
956531,956377,154,0,154,0,3,3
999465,998494,971,0,971,0,15,15
994696,993092,1604,0,1604,0,17,17
990045,988132,1913,0,1913,0,18,18
993032,992893,139,77,62,0,3,4
1002251,1001972,279,0,279,0,14,14
986559,986308,251,0,251,0,6,6
993608,993312,296,212,84,0,2,3
997879,997879,0,0,0,0,0,0
992216,992215,1,0,1,0,1,1
990376,990334,42,0,42,0,2,2
998503,996836,1667,0,1667,0,19,19
990245,988904,1341,0,1341,0,18,18
990055,987298,2757,0,2757,0,19,19
1005893,1005431,462,0,462,0,4,4
