coverage,wt.counts,mut.count,s.count,ns.count,stp.count,aa.sampled,codons.sampled
204775,204383,392,0,392,0,18,18
204562,204397,165,0,165,0,14,14
203195,202831,364,0,364,0,15,15
203870,203762,108,0,108,0,6,6
202920,202523,397,0,397,0,13,13
201146,201145,1,0,1,0,1,1
201716,200732,984,0,984,0,19,19
200145,199423,722,0,722,0,19,19
202688,201652,1036,0,1036,0,18,18
200853,200027,826,0,826,0,19,19
200631,199757,874,0,874,0,19,19
201510,200746,764,40,724,0,19,20
202531,201643,888,0,888,0,19,19
200468,199497,971,0,971,0,19,19
196711,196203,508,0,508,0,15,15
199547,198895,652,0,652,0,19,19
202136,201766,370,0,370,0,18,18
201703,201295,408,0,408,0,18,18
195406,194864,542,0,542,0,16,16
195674,195612,62,0,62,0,3,3
194812,194194,618,28,590,0,17,18
194547,194347,200,0,200,0,7,7
191292,190914,378,0,378,0,17,17
189833,189732,101,0,101,0,11,11
185642,185353,289,18,271,0,13,14
185687,185686,1,0,1,0,1,1
134482,134155,327,22,305,0,16,17
136363,136219,144,0,144,0,12,12
135109,134687,422,0,422,0,19,19
136043,135632,411,32,379,0,19,20
135263,134841,422,0,422,0,19,19
134219,133992,227,0,227,0,14,14
134707,134297,410,0,410,0,18,18
133440,133115,325,0,325,0,18,18
130709,130236,473,0,473,0,17,17
130531,130210,321,0,321,0,19,19
129478,129291,187,0,187,0,12,12
128279,128113,166,0,166,0,17,17
130681,130233,448,0,448,0,19,19
129182,128829,353,3,350,0,18,19
128170,127602,568,0,568,0,19,19
126865,126403,462,0,462,0,19,19
121957,121905,52,9,43,0,7,8
121586,121586,0,0,0,0,0,0
120521,120398,123,48,75,0,7,8
120434,120257,177,14,163,0,13,14
120774,120670,104,0,104,0,6,6
120761,120514,247,17,230,0,16,17
121565,121400,165,0,165,0,14,14
120933,120556,377,0,377,0,19,19
118906,118504,402,0,402,0,19,19
115893,115502,391,0,391,0,19,19
114349,114082,267,0,267,0,15,15
112850,112497,353,0,353,0,19,19
110747,110277,470,0,470,0,19,19
109805,109504,301,0,301,0,18,18
108954,108267,687,0,687,0,19,19
106754,106426,328,0,328,0,13,13
103198,103128,70,0,70,0,9,9
101049,100743,306,10,296,0,19,20
100307,100307,0,0,0,0,0,0
99424,99067,357,0,357,0,19,19
96592,96591,1,0,1,0,1,1
94349,94098,251,0,251,0,19,19
93158,92818,340,0,340,0,18,18
89649,89635,14,0,14,0,2,2
86799,86473,326,0,326,0,16,16
86830,86793,37,0,37,0,4,4
85663,85442,221,0,221,0,17,17
85675,85586,89,0,89,0,11,11
85685,85425,260,0,260,0,19,19
84418,84316,102,14,88,0,13,14
83231,82868,363,0,363,0,18,18
82792,82476,316,0,316,0,19,19
81786,81447,339,0,339,0,18,18
80811,80420,391,0,391,0,19,19
82067,81834,233,0,233,0,16,16
79521,79250,271,0,271,0,17,17
79160,79051,109,0,109,0,13,13
77943,77677,266,12,254,0,19,20
77326,77189,137,0,137,0,12,12
76996,76822,174,0,174,0,19,19
74410,74172,238,0,238,0,19,19
73623,73443,180,0,180,0,18,18
72011,71796,215,0,215,0,19,19
72731,72566,165,6,159,0,17,18
71934,71704,230,0,230,0,16,16
72111,71828,283,0,283,0,19,19
70353,70274,79,0,79,0,9,9
69647,69433,214,0,214,0,18,18
69963,69702,261,0,261,0,19,19
71132,71007,125,9,116,0,7,8
70186,69971,215,0,215,0,18,18
72276,72183,93,0,93,0,12,12
73137,73102,35,0,35,0,2,2
72750,72567,183,0,183,0,19,19
72878,72586,292,15,277,0,17,18
73312,73248,64,10,54,0,10,11
74183,73933,250,0,250,0,19,19
75087,75080,7,0,7,0,4,4
75710,75479,231,4,227,0,19,20
75034,74862,172,0,172,0,18,18
75503,75437,66,0,66,0,8,8
76652,76480,172,6,166,0,14,15
77380,77045,335,61,274,0,18,19
77637,77599,38,0,38,0,5,5
77678,77391,287,0,287,0,19,19
77883,77853,30,0,30,0,4,4
78241,77992,249,0,249,0,18,18
78117,78043,74,10,64,0,7,8
78625,78378,247,0,247,0,18,18
78819,78554,265,0,265,0,19,19
78259,78258,1,0,1,0,1,1
78089,78086,3,0,3,0,2,2
80476,80472,4,0,4,0,2,2
80685,80682,3,0,3,0,1,1
80292,80058,234,0,234,0,14,14
80030,79710,320,0,320,0,19,19
79497,79375,122,22,100,0,9,10
79064,78870,194,6,188,0,18,19
78861,78861,0,0,0,0,0,0
79646,79404,242,0,242,0,18,18
80384,80383,1,0,1,0,1,1
81652,81652,0,0,0,0,0,0
80889,80796,93,0,93,0,14,14
80872,80778,94,0,94,0,11,11
80967,80943,24,0,24,0,1,1
81364,81269,95,0,95,0,10,10
80619,80584,35,0,35,0,9,9
80142,80124,18,0,18,0,4,4
79501,79435,66,0,66,0,7,7
79454,79447,7,0,7,0,3,3
78494,78368,126,0,126,0,15,15
76449,76230,219,0,219,0,19,19
77327,77123,204,0,204,0,18,18
75996,75790,206,0,206,0,18,18
75303,75255,48,0,48,0,5,5
76673,76673,0,0,0,0,0,0
76641,76553,88,0,88,0,8,8
76188,76063,125,0,125,0,10,10
76821,76709,112,0,112,0,13,13
77369,77222,147,0,147,0,8,8
75927,75911,16,5,11,0,1,2
75997,75937,60,0,60,0,12,12
74872,74681,191,10,181,0,14,15
75293,75013,280,12,268,0,18,19
74841,74740,101,0,101,0,13,13
74926,74850,76,3,73,0,7,8
74852,74732,120,0,120,0,14,14
74768,74612,156,0,156,0,19,19
74502,74408,94,0,94,0,18,18
75269,75225,44,0,44,0,7,7
73758,73627,131,0,131,0,14,14
72110,71936,174,0,174,0,17,17
71545,71545,0,0,0,0,0,0
71603,71593,10,0,10,0,3,3
71610,71582,28,0,28,0,3,3
71165,71072,93,0,93,0,11,11
73316,73264,52,0,52,0,9,9
72699,72691,8,0,8,0,2,2
71511,71494,17,0,17,0,3,3
72195,72129,66,0,66,0,13,13
71703,71585,118,0,118,0,17,17
72194,72190,4,3,1,0,1,2
71217,71217,0,0,0,0,0,0
71619,71518,101,0,101,0,17,17
70847,70838,9,0,9,0,3,3
70893,70893,0,0,0,0,0,0
68947,68947,0,0,0,0,0,0
69376,69236,140,9,131,0,17,18
69953,69953,0,0,0,0,0,0
70574,70573,1,0,1,0,1,1
70743,70736,7,0,7,0,3,3
71042,70939,103,0,103,0,15,15
71024,70956,68,0,68,0,10,10
71516,71499,17,0,17,0,3,3
71066,70950,116,0,116,0,13,13
72288,72202,86,0,86,0,17,17
72320,72300,20,0,20,0,5,5
70986,70910,76,0,76,0,8,8
70880,70697,183,0,183,0,17,17
71404,71274,130,6,124,0,16,17
71802,71748,54,18,36,0,4,5
71638,71538,100,0,100,0,8,8
73077,72994,83,0,83,0,13,13
73344,73244,100,10,90,0,15,16
73765,73734,31,9,22,0,5,6
74372,74231,141,0,141,0,13,13
74152,74111,41,0,41,0,9,9
73816,73728,88,0,88,0,12,12
72043,72016,27,0,27,0,8,8
71919,71812,107,1,106,0,12,13
71712,71634,78,0,78,0,11,11
72941,72906,35,30,5,0,3,4
72745,72719,26,0,26,0,8,8
73746,73729,17,0,17,0,4,4
73929,73907,22,11,11,0,4,5
72555,72525,30,5,25,0,4,5
72665,72599,66,0,66,0,12,12
73129,73082,47,0,47,0,12,12
72879,72854,25,9,16,0,4,5
73238,73212,26,0,26,0,7,7
74356,74340,16,0,16,0,6,6
75233,75223,10,0,10,0,3,3
74001,73963,38,0,38,0,5,5
73914,73897,17,5,12,0,2,3
75061,75017,44,0,44,0,3,3
74772,74739,33,3,30,0,6,7
74809,74794,15,0,15,0,3,3
75119,75100,19,0,19,0,2,2
76101,76048,53,0,53,0,6,6
76060,76022,38,0,38,0,6,6
75887,75849,38,5,33,0,12,13
76115,76058,57,0,57,0,8,8
75699,75619,80,0,80,0,15,15
75871,75818,53,0,53,0,9,9
76844,76836,8,0,8,0,2,2
76509,76380,129,4,125,0,17,18
76468,76369,99,0,99,0,10,10
76765,76725,40,0,40,0,7,7
77694,77636,58,0,58,0,7,7
77766,77711,55,0,55,0,7,7
77846,77842,4,0,4,0,2,2
76307,76283,24,0,24,0,6,6
76283,76259,24,18,6,0,1,2
75935,75908,27,0,27,0,4,4
75324,75267,57,32,25,0,6,7
75719,75692,27,0,27,0,5,5
75584,75572,12,0,12,0,5,5
76398,76374,24,0,24,0,6,6
76300,76190,110,0,110,0,13,13
76184,76070,114,7,107,0,17,18
75435,75425,10,7,3,0,1,2
74043,74043,0,0,0,0,0,0
73631,73606,25,0,25,0,4,4
74518,74421,97,21,76,0,13,14
75207,75152,55,0,55,0,11,11
74715,74683,32,23,9,0,3,4
73807,73803,4,0,4,0,1,1
73244,73122,122,0,122,0,16,16
73306,73301,5,0,5,0,3,3
72961,72938,23,0,23,0,4,4
73774,73714,60,3,57,0,10,11
74941,74852,89,0,89,0,12,12
75432,75343,89,0,89,0,13,13
73818,73748,70,0,70,0,10,10
72990,72918,72,0,72,0,12,12
72446,72389,57,0,57,0,10,10
72401,72275,126,0,126,0,16,16
72021,71868,153,0,153,0,15,15
72195,72136,59,0,59,0,6,6
73317,73175,142,0,142,0,16,16
73638,73571,67,8,59,0,9,10
73031,73031,0,0,0,0,0,0
71637,71534,103,0,103,0,10,10
70707,70557,150,0,150,0,17,17
70155,70044,111,4,107,0,15,16
71925,71920,5,0,5,0,1,1
71988,71944,44,6,38,0,8,9
71804,71802,2,0,2,0,1,1
72291,72271,20,0,20,0,6,6
72650,72645,5,0,5,0,2,2
72251,72209,42,0,42,0,8,8
72518,72496,22,0,22,0,6,6
72162,72092,70,0,70,0,9,9
71105,71036,69,0,69,0,8,8
70950,70862,88,0,88,0,10,10
70592,70583,9,0,9,0,5,5
70212,70168,44,0,44,0,7,7
70133,70118,15,0,15,0,1,1
70164,70157,7,0,7,0,4,4
68258,68203,55,0,55,0,7,7
67460,67453,7,0,7,0,2,2
68703,68690,13,0,13,0,2,2
68692,68662,30,0,30,0,3,3
68656,68603,53,0,53,0,6,6
68597,68523,74,0,74,0,14,14
69459,69456,3,0,3,0,1,1
69512,69476,36,0,36,0,5,5
67997,67888,109,0,109,0,17,17
68248,68218,30,0,30,0,6,6
67718,67716,2,0,2,0,1,1
66830,66774,56,0,56,0,10,10
67376,67295,81,0,81,0,15,15
67776,67763,13,0,13,0,4,4
68333,68305,28,1,27,0,7,8
68460,68431,29,0,29,0,7,7
69293,69146,147,0,147,0,15,15
69572,69480,92,0,92,0,14,14
69474,69459,15,0,15,0,3,3
69339,69221,118,4,114,0,14,15
68471,68431,40,0,40,0,10,10
68628,68446,182,0,182,0,17,17
68884,68806,78,0,78,0,12,12
68722,68625,97,22,75,0,12,13
69295,69164,131,0,131,0,16,16
70052,70023,29,0,29,0,6,6
68125,68036,89,0,89,0,12,12
69334,69207,127,0,127,0,17,17
70071,70069,2,0,2,0,1,1
69533,69467,66,6,60,0,8,9
70156,69999,157,0,157,0,17,17
70601,70508,93,12,81,0,11,12
70449,70396,53,9,44,0,5,6
70956,70903,53,0,53,0,9,9
70360,70301,59,0,59,0,9,9
70713,70683,30,22,8,0,2,3
71431,71369,62,0,62,0,12,12
72089,72081,8,1,7,0,2,3
72094,72046,48,18,30,0,4,5
72488,72478,10,0,10,0,5,5
73632,73571,61,6,55,0,8,9
74372,74372,0,0,0,0,0,0
74900,74850,50,0,50,0,4,4
75489,75333,156,0,156,0,15,15
75911,75808,103,0,103,0,10,10
76503,76490,13,0,13,0,2,2
76555,76525,30,0,30,0,9,9
77684,77666,18,0,18,0,6,6
78701,78690,11,6,5,0,2,3
78565,78516,49,0,49,0,8,8
78014,78014,0,0,0,0,0,0
78397,78322,75,22,53,0,7,8
76802,76802,0,0,0,0,0,0
76220,76116,104,14,90,0,13,14
76946,76850,96,0,96,0,11,11
76487,76487,0,0,0,0,0,0
76435,76434,1,0,1,0,1,1
75825,75744,81,0,81,0,13,13
76416,76376,40,17,23,0,3,4
78384,78368,16,0,16,0,2,2
78063,77956,107,4,103,0,11,12
78575,78575,0,0,0,0,0,0
77472,77410,62,0,62,0,5,5
77390,77361,29,0,29,0,7,7
77447,77430,17,0,17,0,3,3
78278,78261,17,0,17,0,2,2
78119,78097,22,0,22,0,5,5
80076,80054,22,0,22,0,4,4
80223,80196,27,0,27,0,7,7
79445,79408,37,0,37,0,7,7
80140,80104,36,36,0,0,0,1
81490,81437,53,0,53,0,11,11
80475,80440,35,0,35,0,7,7
79631,79586,45,0,45,0,12,12
80845,80845,0,0,0,0,0,0
80495,80385,110,8,102,0,12,13
80049,80017,32,0,32,0,5,5
80869,80840,29,0,29,0,5,5
82467,82292,175,0,175,0,17,17
81551,81540,11,0,11,0,1,1
80551,80494,57,0,57,0,8,8
80640,80619,21,0,21,0,4,4
81417,81339,78,10,68,0,9,10
79583,79549,34,0,34,0,3,3
79016,78953,63,0,63,0,9,9
80667,80491,176,2,174,0,17,18
80613,80512,101,29,72,0,5,6
78924,78924,0,0,0,0,0,0
77786,77770,16,0,16,0,3,3
78818,78786,32,0,32,0,5,5
79524,79481,43,0,43,0,4,4
80268,80083,185,22,163,0,14,15
81579,81526,53,0,53,0,6,6
82188,82178,10,0,10,0,1,1
82248,82246,2,0,2,0,1,1
81462,81443,19,0,19,0,2,2
82229,82229,0,0,0,0,0,0
82269,82267,2,0,2,0,1,1
81802,81802,0,0,0,0,0,0
81759,81759,0,0,0,0,0,0
81706,81704,2,0,2,0,1,1
82455,82455,0,0,0,0,0,0
82500,82500,0,0,0,0,0,0
83178,83178,0,0,0,0,0,0
82182,82182,0,0,0,0,0,0
82241,82241,0,0,0,0,0,0
80590,80590,0,0,0,0,0,0
81648,81595,53,6,47,0,7,8
81446,81408,38,24,14,0,2,3
81180,81143,37,12,25,0,1,2
80123,80116,7,0,7,0,2,2
79782,79778,4,0,4,0,1,1
80350,80222,128,40,88,0,13,14
80740,80740,0,0,0,0,0,0
80863,80863,0,0,0,0,0,0
80066,80022,44,0,44,0,7,7
78275,78275,0,0,0,0,0,0
78097,78096,1,0,1,0,1,1
78570,78566,4,4,0,0,0,1
78278,78266,12,0,12,0,2,2
78011,77996,15,0,15,0,2,2
78623,78623,0,0,0,0,0,0
78366,78291,75,0,75,0,9,9
77437,77289,148,55,93,0,5,6
76325,76290,35,0,35,0,3,3
75091,75091,0,0,0,0,0,0
75378,75354,24,14,10,0,2,3
75235,75170,65,14,51,0,9,10
75434,75409,25,12,13,0,2,3
76114,76084,30,0,30,0,2,2
76693,76512,181,0,181,0,15,15
76730,76689,41,0,41,0,7,7
76038,75945,93,13,80,0,7,8
75767,75712,55,0,55,0,12,12
77210,77189,21,8,13,0,3,4
77952,77918,34,7,27,0,4,5
77895,77812,83,0,83,0,11,11
78853,78853,0,0,0,0,0,0
79196,79179,17,14,3,0,1,2
79891,79875,16,15,1,0,1,2
78812,78812,0,0,0,0,0,0
79093,79093,0,0,0,0,0,0
79678,79678,0,0,0,0,0,0
79058,79058,0,0,0,0,0,0
79305,79172,133,0,133,0,14,14
79980,79971,9,0,9,0,2,2
80616,80603,13,0,13,0,2,2
81921,81921,0,0,0,0,0,0
81624,81608,16,0,16,0,3,3
81201,81201,0,0,0,0,0,0
80800,80800,0,0,0,0,0,0
80511,80468,43,0,43,0,5,5
80638,80628,10,0,10,0,2,2
80302,80231,71,0,71,0,9,9
80733,80707,26,0,26,0,4,4
80393,80327,66,0,66,0,6,6
81521,81512,9,0,9,0,1,1
80075,80067,8,0,8,0,3,3
80684,80682,2,0,2,0,1,1
80492,80492,0,0,0,0,0,0
79960,79942,18,18,0,0,0,1
79212,79167,45,0,45,0,5,5
78170,78170,0,0,0,0,0,0
77654,77654,0,0,0,0,0,0
77163,77163,0,0,0,0,0,0
76019,76017,2,0,2,0,1,1
77161,77157,4,0,4,0,1,1
77118,77060,58,0,58,0,8,8
74973,74973,0,0,0,0,0,0
73851,73844,7,0,7,0,3,3
74100,74092,8,4,4,0,2,3
74762,74715,47,29,18,0,5,6
74315,74311,4,0,4,0,1,1
74213,74213,0,0,0,0,0,0
74633,74633,0,0,0,0,0,0
74884,74879,5,0,5,0,1,1
74036,74035,1,0,1,0,1,1
73863,73855,8,8,0,0,0,1
75009,74970,39,9,30,0,2,3
75379,75379,0,0,0,0,0,0
75298,75291,7,0,7,0,1,1
75199,75199,0,0,0,0,0,0
74674,74622,52,0,52,0,10,10
74120,74112,8,0,8,0,3,3
74864,74864,0,0,0,0,0,0
72130,72127,3,0,3,0,1,1
72224,72224,0,0,0,0,0,0
72250,72234,16,0,16,0,6,6
72483,72459,24,18,6,0,1,2
72490,72476,14,0,14,0,2,2
72319,72300,19,0,19,0,4,4
71694,71693,1,0,1,0,1,1
72116,72116,0,0,0,0,0,0
73407,73337,70,0,70,0,9,9
74029,73958,71,23,48,0,11,12
74827,74827,0,0,0,0,0,0
73917,73820,97,0,97,0,10,10
74371,74362,9,7,2,0,1,2
73035,72937,98,0,98,0,13,13
73391,73356,35,0,35,0,3,3
73303,73285,18,0,18,0,4,4
74216,74178,38,4,34,0,5,6
74403,74402,1,0,1,0,1,1
74015,73994,21,21,0,0,0,1
73790,73790,0,0,0,0,0,0
73073,73071,2,0,2,0,1,1
72561,72460,101,0,101,0,9,9
72418,72417,1,0,1,0,1,1
73130,73122,8,1,7,0,1,2
73103,73092,11,0,11,0,2,2
73457,73428,29,0,29,0,4,4
73916,73908,8,0,8,0,1,1
73725,73687,38,0,38,0,3,3
73315,73315,0,0,0,0,0,0
73180,73162,18,0,18,0,2,2
73423,73413,10,10,0,0,0,1
74284,74284,0,0,0,0,0,0
72663,72632,31,14,17,0,2,3
72680,72658,22,22,0,0,0,1
71980,71980,0,0,0,0,0,0
71441,71409,32,25,7,0,3,4
71233,71192,41,0,41,0,9,9
72803,72789,14,13,1,0,1,2
71684,71676,8,8,0,0,0,1
72376,72367,9,0,9,0,1,1
71917,71848,69,0,69,0,13,13
73153,73139,14,0,14,0,3,3
73005,73005,0,0,0,0,0,0
72266,72228,38,0,38,0,7,7
72024,72024,0,0,0,0,0,0
71489,71484,5,0,5,0,2,2
71510,71510,0,0,0,0,0,0
72345,72294,51,0,51,0,8,8
72428,72347,81,0,81,0,8,8
73292,73239,53,8,45,0,9,10
74758,74535,223,0,223,0,13,13
74023,73984,39,0,39,0,3,3
74383,74281,102,13,89,0,12,13
75041,74878,163,0,163,0,16,16
75494,75318,176,0,176,0,15,15
76203,76144,59,0,59,0,10,10
77019,76957,62,0,62,0,11,11
79990,79924,66,0,66,0,6,6
80727,80599,128,0,128,0,14,14
80921,80891,30,0,30,0,3,3
84059,83962,97,0,97,0,14,14
84927,84716,211,0,211,0,17,17
86180,86091,89,9,80,0,7,8
86459,86438,21,0,21,0,2,2
87681,87455,226,0,226,0,18,18
89198,88851,347,0,347,0,19,19
89204,89203,1,0,1,0,1,1
89376,89309,67,0,67,0,12,12
94471,94303,168,0,168,0,17,17
94171,94118,53,0,52,1,6,6
93221,93196,25,0,25,0,3,3
93908,93744,164,0,164,0,16,16
95464,95424,40,0,40,0,7,7
97445,97297,148,0,148,0,12,12
97516,97516,0,0,0,0,0,0
99072,99068,4,0,4,0,1,1
100933,100861,72,0,72,0,3,3
101675,101576,99,0,99,0,13,13
103449,103449,0,0,0,0,0,0
102770,102721,49,0,49,0,6,6
104422,104411,11,0,11,0,2,2
105592,105550,42,8,34,0,4,5
105498,105475,23,0,23,0,4,4
109844,109843,1,0,1,0,1,1
117259,117249,10,0,10,0,1,1
119161,119107,54,0,54,0,7,7
119305,119261,44,0,44,0,2,2
118228,118127,101,0,101,0,8,8
119023,119023,0,0,0,0,0,0
121329,121260,69,0,69,0,6,6
122537,122485,52,0,52,0,10,10
124554,124495,59,0,59,0,6,6
126167,126134,33,28,5,0,1,2
125609,125498,111,37,74,0,9,10
125865,125709,156,0,156,0,17,17
126355,126283,72,0,72,0,6,6
127958,127812,146,0,146,0,15,15
130179,130161,18,18,0,0,0,1
132478,132339,139,0,139,0,9,9
133068,133019,49,27,22,0,4,5
131858,131718,140,43,97,0,5,6
134509,134509,0,0,0,0,0,0
137018,136922,96,0,96,0,6,6
138253,138149,104,22,82,0,4,5
139291,139240,51,0,51,0,4,4
139880,139770,110,0,110,0,9,9
139504,139459,45,0,45,0,2,2
136163,136011,152,0,152,0,6,6
137242,136950,292,0,292,0,16,16
139605,139363,242,56,186,0,16,17
142721,142662,59,0,59,0,6,6
141561,141418,143,0,143,0,7,7
192222,191502,720,0,720,0,18,18
193706,193563,143,0,143,0,13,13
193822,193757,65,65,0,0,0,1
195256,195166,90,0,90,0,13,13
198909,198285,624,22,602,0,16,17
193054,193017,37,0,37,0,3,3
201669,201410,259,0,259,0,12,12
201319,200924,395,0,395,0,14,14
200622,200185,437,0,437,0,16,16
201090,201061,29,22,7,0,1,2
203039,202956,83,0,83,0,9,9
199960,199923,37,0,37,0,3,3
201580,201488,92,70,22,0,2,3
202659,202659,0,0,0,0,0,0
200971,200971,0,0,0,0,0,0
200438,200414,24,0,24,0,2,2
202030,201688,342,0,342,0,17,17
200439,200048,391,0,391,0,17,17
199898,199090,808,0,808,0,19,19
203860,203804,56,0,56,0,2,2
