coverage,wt.counts,mut.count,s.count,ns.count,stp.count,aa.sampled,codons.sampled
961833,960074,1759,0,1759,0,18,18
961051,960304,747,0,747,0,15,15
955855,953810,2045,0,2045,0,19,19
958525,958121,404,0,404,0,12,12
954959,953499,1460,0,1460,0,17,17
948000,947992,8,0,8,0,3,3
949731,946170,3561,0,3561,0,19,19
940326,936159,4167,0,4167,0,19,19
953659,950120,3539,0,3539,0,19,19
943623,940261,3362,0,3362,0,19,19
940414,936258,4156,0,4156,0,19,19
945197,941405,3792,208,3584,0,19,20
951949,947675,4274,0,4274,0,19,19
939639,936617,3022,0,3022,0,19,19
920992,919634,1358,0,1358,0,17,17
934659,931899,2760,0,2760,0,19,19
949397,947637,1760,0,1760,0,19,19
949102,947270,1832,0,1832,0,19,19
910692,907891,2801,0,2801,0,17,17
921422,921275,147,0,147,0,3,3
918434,916243,2191,162,2029,0,17,18
917895,917053,842,0,842,0,8,8
903886,902100,1786,0,1786,0,18,18
900038,899496,542,0,542,0,11,11
881769,880372,1397,123,1274,0,18,19
882604,882602,2,0,2,0,1,1
667226,665417,1809,86,1723,0,18,19
675601,674984,617,0,617,0,16,16
671696,669874,1822,0,1822,0,19,19
675321,673338,1983,118,1865,0,19,20
671485,669550,1935,0,1935,0,19,19
668014,667056,958,0,958,0,18,18
667409,665279,2130,0,2130,0,19,19
659788,657919,1869,0,1869,0,19,19
644532,642269,2263,0,2263,0,19,19
642410,640616,1794,0,1794,0,19,19
635120,634581,539,0,539,0,16,16
627742,626948,794,0,794,0,18,18
636330,634784,1546,0,1546,0,19,19
628223,626521,1702,49,1653,0,18,19
620168,618093,2075,0,2075,0,19,19
610164,608511,1653,0,1653,0,19,19
582024,581842,182,77,105,0,12,13
576055,576050,5,0,5,0,3,3
567446,567010,436,63,373,0,8,9
563156,562268,888,53,835,0,14,15
562212,561829,383,0,383,0,8,8
558034,556989,1045,73,972,0,18,19
560023,559154,869,0,869,0,16,16
552786,551227,1559,0,1559,0,19,19
541394,539119,2275,0,2275,0,19,19
524738,522989,1749,0,1749,0,19,19
516813,515632,1181,0,1181,0,18,18
508465,507197,1268,0,1268,0,19,19
497275,495436,1839,0,1839,0,19,19
490259,488974,1285,0,1285,0,19,19
485130,482432,2698,0,2698,0,19,19
472630,471651,979,0,979,0,16,16
454048,453860,188,0,188,0,7,7
441270,440320,950,71,879,0,19,20
437055,437055,0,0,0,0,0,0
431094,429646,1448,0,1448,0,19,19
417318,417315,3,0,3,0,1,1
405177,403735,1442,0,1442,0,19,19
399682,398330,1352,0,1352,0,18,18
382775,382697,78,0,78,0,3,3
368826,367683,1143,0,1143,0,17,17
368127,367977,150,0,150,0,10,10
363055,362538,517,0,517,0,19,19
362468,362134,334,0,334,0,14,14
360648,359658,990,0,990,0,19,19
355843,355447,396,50,346,0,15,16
351231,349780,1451,0,1451,0,18,18
349061,348124,937,0,937,0,19,19
344499,343241,1258,0,1258,0,18,18
341338,340234,1104,0,1104,0,19,19
346967,345825,1142,0,1142,0,19,19
336457,335361,1096,0,1096,0,19,19
334852,334505,347,0,347,0,13,13
330885,329936,949,38,911,0,19,20
327333,326900,433,0,433,0,15,15
326858,325892,966,0,966,0,19,19
316782,315863,919,0,919,0,19,19
313387,312721,666,0,666,0,19,19
307965,307275,690,0,690,0,19,19
311307,310367,940,45,895,0,19,20
308499,307715,784,0,784,0,19,19
310565,309542,1023,0,1023,0,19,19
304291,303865,426,0,426,0,11,11
301788,300936,852,0,852,0,19,19
304610,303610,1000,0,1000,0,19,19
309215,308900,315,38,277,0,12,13
306109,305202,907,0,907,0,19,19
315595,315280,315,0,315,0,19,19
319322,319260,62,0,62,0,6,6
317831,316874,957,0,957,0,19,19
318685,317613,1072,74,998,0,19,20
319850,319493,357,43,314,0,15,16
323809,322955,854,0,854,0,19,19
328093,328059,34,0,34,0,6,6
330045,329233,812,35,777,0,19,20
326662,326055,607,0,607,0,18,18
328424,328138,286,0,286,0,10,10
332206,331622,584,28,556,0,18,19
335001,333991,1010,94,916,0,19,20
334671,334436,235,0,235,0,7,7
333736,332857,879,0,879,0,19,19
335192,335034,158,0,158,0,6,6
336009,334932,1077,0,1077,0,19,19
336515,336170,345,73,272,0,9,10
337557,336391,1166,0,1166,0,18,18
339297,338326,971,0,971,0,19,19
336516,336509,7,0,7,0,4,4
336095,336050,45,0,45,0,8,8
346068,346065,3,0,3,0,2,2
346498,346455,43,0,43,0,3,3
344697,343895,802,0,802,0,17,17
342566,341173,1393,0,1393,0,19,19
339660,339367,293,72,221,0,8,9
338701,337522,1179,41,1138,0,18,19
337131,337130,1,0,1,0,1,1
340150,339151,999,0,999,0,19,19
342501,342495,6,0,6,0,2,2
347828,347828,0,0,0,0,0,0
343862,343422,440,0,440,0,16,16
343193,342890,303,0,303,0,12,12
342614,342491,123,0,123,0,2,2
343880,343553,327,0,327,0,14,14
340902,340657,245,0,245,0,9,9
337685,337613,72,0,72,0,5,5
334805,334413,392,0,392,0,11,11
335443,335416,27,0,27,0,3,3
329936,329335,601,0,601,0,17,17
321158,320018,1140,0,1140,0,19,19
324610,323679,931,0,931,0,19,19
317856,316981,875,0,875,0,18,18
315170,314997,173,0,173,0,10,10
320746,320745,1,0,1,0,1,1
321588,321281,307,0,307,0,9,9
319326,318973,353,0,353,0,11,11
322919,322379,540,0,540,0,16,16
324731,324252,479,0,479,0,11,11
318226,318172,54,37,17,0,5,6
318399,318060,339,0,339,0,16,16
313316,312748,568,20,548,0,18,19
314026,313249,777,43,734,0,19,20
312155,311799,356,0,356,0,15,15
312345,312046,299,44,255,0,8,9
312045,311590,455,0,455,0,17,17
312567,311985,582,0,582,0,19,19
312034,311617,417,0,417,0,18,18
314472,314067,405,0,405,0,9,9
309568,309064,504,0,504,0,15,15
301360,300624,736,0,736,0,18,18
300102,300099,3,0,3,0,1,1
300219,300160,59,0,59,0,5,5
300008,299924,84,0,84,0,5,5
298633,298272,361,0,361,0,12,12
307684,307427,257,0,257,0,13,13
304635,304603,32,0,32,0,2,2
299547,299438,109,0,109,0,5,5
301718,301299,419,0,419,0,18,18
299718,299238,480,0,480,0,18,18
301042,301004,38,17,21,0,1,2
297845,297845,0,0,0,0,0,0
299311,298882,429,0,429,0,18,18
295166,295122,44,0,44,0,5,5
294837,294830,7,0,7,0,1,1
285690,285683,7,0,7,0,2,2
286788,286165,623,45,578,0,18,19
289804,289804,0,0,0,0,0,0
291833,291832,1,0,1,0,1,1
293395,293312,83,0,83,0,8,8
294548,293991,557,0,557,0,17,17
294362,294075,287,0,287,0,14,14
295674,295581,93,0,93,0,4,4
294357,293753,604,0,604,0,16,16
299359,299005,354,0,354,0,18,18
300105,299919,186,0,186,0,8,8
294343,294157,186,0,186,0,9,9
293666,293011,655,0,655,0,18,18
295989,295381,608,35,573,0,18,19
297767,297563,204,83,121,0,6,7
297298,297022,276,0,276,0,10,10
303366,303000,366,0,366,0,18,18
304931,304314,617,62,555,0,18,19
306718,306579,139,23,116,0,6,7
310297,309747,550,0,549,1,17,17
309014,308849,165,0,165,0,12,12
307892,307495,397,0,397,0,17,17
300076,299830,246,0,246,0,14,14
299358,298730,628,5,623,0,14,15
299183,298890,293,0,293,0,13,13
304696,304591,105,13,92,0,9,10
303653,303550,103,0,103,0,12,12
307932,307861,71,0,71,0,10,10
308296,308206,90,27,63,0,5,6
303530,303395,135,52,83,0,7,8
304268,304006,262,0,262,0,14,14
306713,306400,313,0,313,0,15,15
305908,305725,183,44,139,0,5,6
308307,308188,119,0,119,0,8,8
314165,314110,55,0,55,0,8,8
317743,317595,148,0,148,0,5,5
312446,312272,174,0,174,0,5,5
312232,312166,66,25,41,0,4,5
317102,317026,76,0,76,0,11,11
315452,315297,155,55,100,0,6,7
315934,315848,86,0,86,0,5,5
316954,316889,65,0,65,0,4,4
320711,320538,173,0,173,0,8,8
320501,320311,190,0,190,0,9,9
319676,319421,255,31,224,0,16,17
319863,319557,306,0,306,0,11,11
318583,318158,425,0,425,0,19,19
318019,317826,193,0,193,0,17,17
322344,322320,24,0,24,0,1,1
322037,321589,448,31,417,0,17,18
322329,322057,272,0,272,0,13,13
323318,323127,191,0,191,0,8,8
327529,327321,208,0,208,0,13,13
328081,327858,223,0,223,0,11,11
328730,328707,23,0,23,0,4,4
322710,322488,222,0,222,0,10,10
323017,322847,170,99,71,0,5,6
320874,320717,157,0,157,0,8,8
318020,317884,136,36,100,0,8,9
320594,320479,115,0,115,0,7,7
320873,320821,52,0,52,0,6,6
324593,324449,144,0,144,0,7,7
323462,322862,600,0,600,0,19,19
322544,322130,414,16,398,0,18,19
318435,318368,67,54,13,0,2,3
312897,312897,0,0,0,0,0,0
311209,311059,150,0,150,0,8,8
315147,314738,409,57,352,0,13,14
318263,318041,222,0,222,0,15,15
316992,316868,124,14,110,0,5,6
313208,313156,52,0,52,0,1,1
311906,311504,402,0,402,0,18,18
313062,313010,52,0,52,0,6,6
313367,313295,72,0,72,0,6,6
316655,316444,211,15,196,0,14,15
322985,322571,414,0,414,0,18,18
325338,324868,470,0,470,0,17,17
318355,317908,447,0,447,0,13,13
315581,315216,365,0,365,0,17,17
313688,313390,298,0,298,0,15,15
314104,313447,657,0,657,0,19,19
312262,311636,626,0,626,0,19,19
313518,313321,197,0,197,0,8,8
318152,317481,671,0,671,0,18,18
319481,319151,330,59,271,0,13,14
318764,318764,0,0,0,0,0,0
312382,312034,348,0,348,0,12,12
308693,307995,698,0,698,0,18,18
306276,305794,482,31,451,0,19,20
313327,313303,24,0,24,0,1,1
313612,313326,286,34,252,0,11,12
313704,313692,12,0,12,0,2,2
316022,315886,136,0,136,0,13,13
316652,316591,61,0,61,0,6,6
315377,315119,258,0,258,0,14,14
317215,317110,105,0,105,0,11,11
314810,314348,462,0,462,0,13,13
309298,309001,297,0,297,0,11,11
308494,308117,377,0,377,0,12,12
307204,307166,38,0,38,0,7,7
305429,305245,184,0,184,0,10,10
305764,305723,41,0,41,0,2,2
305627,305610,17,0,17,0,2,2
298326,298090,236,0,236,0,10,10
293920,293904,16,0,16,0,1,1
300077,300011,66,0,66,0,4,4
299521,299398,123,0,123,0,4,4
299725,299581,144,0,144,0,10,10
299469,299013,456,0,456,0,18,18
303389,303389,0,0,0,0,0,0
302687,302481,206,0,206,0,6,6
297250,296777,473,0,473,0,18,18
297551,297435,116,0,116,0,7,7
295867,295861,6,0,6,0,2,2
292432,292218,214,0,214,0,12,12
294931,294545,386,0,386,0,16,16
296316,296227,89,0,89,0,4,4
298582,298395,187,32,155,0,7,8
298859,298741,118,0,118,0,10,10
301898,301118,780,0,780,0,18,18
302985,302556,429,0,429,0,18,18
302654,302532,122,0,122,0,8,8
301707,301076,631,43,588,0,18,19
297132,296929,203,0,203,0,19,19
298181,297643,538,0,538,0,18,18
299718,299419,299,0,299,0,14,14
298142,297625,517,80,437,0,17,18
300746,300087,659,0,659,0,18,18
303559,303404,155,0,155,0,12,12
294431,294093,338,0,338,0,16,16
299664,298904,760,0,760,0,18,18
303308,303274,34,0,34,0,3,3
300460,300141,319,22,297,0,11,12
303009,302421,588,0,588,0,18,18
305852,305510,342,28,314,0,17,18
303956,303785,171,13,158,0,6,7
307541,307257,284,0,284,0,17,17
305043,304701,342,0,342,0,13,13
306695,306599,96,40,56,0,3,4
309964,309596,368,0,368,0,14,14
312580,312450,130,26,104,0,3,4
313273,313074,199,39,160,0,7,8
315098,315042,56,0,56,0,7,7
319802,319279,523,55,468,0,12,13
322801,322788,13,0,13,0,3,3
325519,325341,178,0,178,0,6,6
327907,327306,601,0,601,0,15,15
330251,329955,296,0,296,0,12,12
331672,331634,38,0,38,0,3,3
332166,332072,94,0,94,0,14,14
336480,336312,168,0,168,0,15,15
341445,341387,58,24,34,0,3,4
340013,339791,222,0,222,0,9,9
338338,338338,0,0,0,0,0,0
339635,339452,183,35,148,0,9,10
332510,332510,0,0,0,0,0,0
330371,329736,635,79,556,0,19,20
334399,334189,210,0,210,0,12,12
332652,332641,11,0,11,0,4,4
332476,332475,1,0,1,0,1,1
330153,329651,502,0,502,0,18,18
332245,332127,118,53,65,0,5,6
340650,340624,26,0,26,0,2,2
339125,338570,555,39,516,0,13,14
341649,341648,1,0,1,0,1,1
337351,337158,193,0,193,0,6,6
336750,336593,157,0,157,0,13,13
336603,336539,64,0,64,0,3,3
339250,339166,84,0,84,0,3,3
337788,337633,155,0,155,0,6,6
345954,345882,72,0,72,0,7,7
345477,345332,145,0,145,0,10,10
342233,342042,191,0,191,0,9,9
345369,345276,93,89,4,0,3,4
350695,350314,381,0,381,0,13,13
346089,345939,150,0,150,0,11,11
342855,342566,289,0,289,0,17,17
349175,349170,5,0,5,0,2,2
347016,346510,506,102,404,0,16,17
344666,344597,69,0,69,0,3,3
348347,348231,116,0,116,0,6,6
354883,354029,854,0,854,0,19,19
350571,350527,44,0,44,0,1,1
346966,346785,181,0,181,0,12,12
347152,347103,49,0,49,0,4,4
350631,350251,380,94,286,0,13,14
342866,342707,159,0,159,0,5,5
340158,339942,216,0,216,0,12,12
346639,345865,774,44,730,0,17,18
345199,344989,210,88,122,0,6,7
338831,338826,5,0,5,0,4,4
333519,333478,41,0,41,0,6,6
338498,338353,145,0,145,0,12,12
341608,341395,213,0,213,0,4,4
344575,343935,640,77,563,0,16,17
350458,350289,169,0,169,0,9,9
352801,352738,63,0,63,0,1,1
352391,352337,54,0,54,0,2,2
348674,348600,74,0,74,0,3,3
351425,351425,0,0,0,0,0,0
350852,350835,17,0,17,0,2,2
349542,349542,0,0,0,0,0,0
348210,348208,2,0,2,0,1,1
348718,348699,19,0,19,0,3,3
351606,351606,0,0,0,0,0,0
352915,352913,2,0,2,0,1,1
356079,356079,0,0,0,0,0,0
351468,351468,0,0,0,0,0,0
351581,351580,1,0,1,0,1,1
343690,343685,5,0,5,0,3,3
346502,346286,216,38,178,0,8,9
345777,345675,102,43,59,0,4,5
343748,343544,204,63,141,0,3,4
338460,338440,20,0,20,0,2,2
337088,337076,12,0,12,0,1,1
338208,337737,471,67,404,0,14,15
340209,340209,0,0,0,0,0,0
340881,340881,0,0,0,0,0,0
337489,337275,214,0,214,0,12,12
329820,329820,0,0,0,0,0,0
329171,329169,2,0,2,0,2,2
331742,331719,23,22,1,0,1,2
330742,330674,68,0,68,0,4,4
329140,329096,44,0,44,0,4,4
333331,333331,0,0,0,0,0,0
332506,332148,358,0,358,0,12,12
328457,328098,359,92,267,0,5,6
323659,323501,158,0,158,0,5,5
318050,318050,0,0,0,0,0,0
318727,318661,66,34,32,0,2,3
317498,317154,344,54,290,0,12,13
318395,318303,92,58,34,0,2,3
320596,320467,129,0,129,0,3,3
323139,322352,787,0,787,0,17,17
322993,322866,127,0,127,0,10,10
319702,319278,424,70,354,0,7,8
319387,319024,363,0,363,0,16,16
325710,325612,98,36,62,0,5,6
329521,329267,254,73,181,0,8,9
329975,329567,408,0,408,0,11,11
334499,334499,0,0,0,0,0,0
335294,335190,104,55,49,0,1,2
337925,337820,105,82,23,0,1,2
332681,332681,0,0,0,0,0,0
333328,333328,0,0,0,0,0,0
336153,336150,3,0,3,0,2,2
334104,334098,6,0,6,0,2,2
334636,334069,567,0,567,0,14,14
338685,338670,15,0,15,0,2,2
341027,340955,72,0,72,0,2,2
347306,347303,3,0,3,0,1,1
346200,346153,47,0,47,0,4,4
345236,345235,1,0,1,0,1,1
342673,342641,32,0,32,0,2,2
341953,341762,191,0,191,0,11,11
341422,341374,48,0,48,0,3,3
339900,339522,378,0,378,0,13,13
341878,341703,175,0,175,0,4,4
341170,340917,253,0,253,0,6,6
345632,345584,48,0,48,0,2,2
339938,339916,22,0,22,0,3,3
341491,341485,6,0,6,0,1,1
340566,340566,0,0,0,0,0,0
338412,338346,66,66,0,0,0,1
334273,334132,141,0,141,0,6,6
331027,331027,0,0,0,0,0,0
328739,328737,2,0,2,0,1,1
327123,327123,0,0,0,0,0,0
323197,323165,32,0,32,0,2,2
328667,328654,13,0,13,0,1,1
327613,327348,265,0,265,0,12,12
318402,318399,3,0,3,0,1,1
314662,314621,41,0,41,0,3,3
315941,315873,68,40,28,0,2,3
319236,319020,216,94,122,0,7,8
317277,317261,16,0,16,0,3,3
316369,316368,1,0,1,0,1,1
318022,318018,4,0,4,0,1,1
319679,319662,17,0,17,0,2,2
315966,315962,4,0,4,0,1,1
315551,315506,45,45,0,0,0,1
319630,319502,128,58,70,0,2,3
320957,320957,0,0,0,0,0,0
320608,320546,62,0,62,0,2,2
319202,319202,0,0,0,0,0,0
317110,316829,281,0,281,0,12,12
314827,314752,75,0,75,0,4,4
317348,317347,1,0,1,0,1,1
304948,304941,7,0,7,0,1,1
305547,305547,0,0,0,0,0,0
305541,305435,106,0,106,0,11,11
306877,306794,83,49,34,0,2,3
307388,307363,25,0,25,0,2,2
307242,307149,93,0,93,0,8,8
304013,304011,2,0,2,0,1,1
306441,306441,0,0,0,0,0,0
312171,311846,325,0,325,0,13,13
314885,314373,512,84,428,0,15,16
318834,318830,4,0,4,0,2,2
314258,313945,313,0,313,0,13,13
315567,315499,68,52,16,0,2,3
309271,308968,303,0,303,0,16,16
310537,310482,55,0,55,0,3,3
310244,310138,106,0,106,0,3,3
314087,313923,164,76,88,0,4,5
314855,314836,19,0,19,0,2,2
313870,313768,102,99,3,0,1,2
313256,313256,0,0,0,0,0,0
309456,309454,2,0,2,0,1,1
308209,308012,197,0,197,0,9,9
309185,309138,47,0,47,0,8,8
312116,312010,106,69,37,0,6,7
312555,312500,55,0,55,0,3,3
313974,313883,91,0,91,0,8,8
315996,315973,23,0,23,0,1,1
315145,314992,153,0,153,0,3,3
313321,313321,0,0,0,0,0,0
311756,311628,128,0,128,0,2,2
312807,312715,92,87,5,0,1,2
317399,317399,0,0,0,0,0,0
310091,309954,137,44,93,0,5,6
310802,310739,63,61,2,0,2,3
307903,307903,0,0,0,0,0,0
305829,305763,66,49,17,0,3,4
304426,304176,250,0,250,0,12,12
310930,310858,72,48,24,0,2,3
306340,306241,99,99,0,0,0,1
308586,308539,47,0,47,0,1,1
307224,306910,314,0,314,0,17,17
311554,311436,118,0,118,0,6,6
311143,311140,3,0,3,0,1,1
307875,307648,227,0,227,0,9,9
305430,305419,11,0,11,0,5,5
302984,302959,25,0,25,0,3,3
302792,302792,0,0,0,0,0,0
305324,305149,175,0,175,0,12,12
305709,305374,335,0,335,0,11,11
308897,308620,277,99,178,0,13,14
313482,312743,739,0,739,0,16,16
310120,310007,113,0,113,0,2,2
310718,310257,461,86,375,0,15,16
313222,312285,937,0,937,0,16,16
313952,313178,774,0,774,0,15,15
315527,315303,224,0,224,0,12,12
319728,319445,283,0,283,0,10,10
331663,331305,358,0,358,0,7,7
335002,334340,662,0,662,0,18,18
335428,335297,131,0,131,0,5,5
348066,347623,443,0,443,0,13,13
351957,350745,1212,0,1212,0,19,19
357737,357426,311,64,247,0,6,7
359000,358928,72,0,72,0,6,6
364373,363092,1281,0,1281,0,19,19
371068,369853,1215,0,1215,0,19,19
371259,371259,0,0,0,0,0,0
372230,372056,174,0,174,0,15,15
396779,396146,633,0,633,0,17,17
395038,394839,199,0,199,0,10,10
391472,391413,59,0,59,0,4,4
394911,394029,882,0,882,0,17,17
401608,401314,294,0,294,0,10,10
410989,410326,663,0,663,0,13,13
412792,412781,11,0,11,0,2,2
422347,422263,84,0,84,0,1,1
434387,434156,231,0,231,0,5,5
440578,440237,341,0,341,0,13,13
449924,449921,3,0,3,0,2,2
447763,447351,412,0,412,0,9,9
461370,461294,76,0,76,0,4,4
468786,468506,280,100,180,0,5,6
470247,470118,129,0,129,0,5,5
494752,494695,57,0,57,0,2,2
534505,534465,40,0,40,0,1,1
544303,544095,208,0,208,0,8,8
547450,547290,160,0,160,0,2,2
544030,543482,548,0,548,0,9,9
552697,552691,6,0,6,0,1,1
569131,568805,326,0,326,0,6,6
577810,577443,367,0,367,0,13,13
590328,590044,284,0,284,0,8,8
600805,600552,253,189,64,0,2,3
600671,600099,572,136,436,0,15,16
605581,604732,849,0,849,0,18,18
609927,609744,183,0,183,0,8,8
622378,621766,612,0,612,0,15,15
637959,637709,250,250,0,0,0,1
653698,653031,667,0,667,0,13,13
662007,661746,261,103,158,0,6,7
658248,657612,636,172,464,0,6,7
674496,674494,2,0,2,0,1,1
689077,688452,625,0,625,0,11,11
698377,697900,477,119,358,0,4,5
707226,706768,458,0,458,0,4,4
711024,710231,793,0,793,0,12,12
711963,711852,111,0,111,0,3,3
697387,696511,876,0,876,0,6,6
702186,700619,1567,0,1567,0,17,17
717074,715627,1447,342,1105,0,17,18
732446,732040,406,0,406,0,11,11
727044,726327,717,0,717,0,7,7
936279,932814,3465,0,3465,0,18,18
941767,940747,1020,0,1020,0,17,17
942987,942641,346,342,4,0,1,2
949349,948574,775,0,775,0,15,15
966828,964106,2722,238,2484,0,18,19
936179,935906,273,0,273,0,3,3
981379,980174,1205,0,1205,0,15,15
976984,974952,2032,0,2032,0,15,15
972938,970801,2137,0,2137,0,18,18
976299,976130,169,107,62,0,2,3
985910,985416,494,0,494,0,13,13
969255,969003,252,0,252,0,7,7
977177,976759,418,284,134,0,2,3
982249,982248,1,0,1,0,1,1
975284,975280,4,0,4,0,1,1
973429,973309,120,0,120,0,2,2
982309,980324,1985,0,1985,0,18,18
973378,971120,2258,0,2258,0,19,19
973033,969381,3652,0,3652,0,19,19
991236,990603,633,0,633,0,2,2
