coverage,wt.counts,mut.count,s.count,ns.count,stp.count,aa.sampled,codons.sampled
1349232,1347650,1582,0,1582,0,19,19
1344153,1342348,1805,0,1805,0,19,19
1341807,1340383,1424,0,1424,0,19,19
1345877,1344135,1742,0,1742,0,19,19
1334916,1332543,2373,0,2373,0,19,19
1327742,1325827,1915,0,1915,0,19,19
1339458,1337715,1743,0,1743,0,19,19
1315225,1313650,1575,0,1575,0,19,19
1345109,1343454,1655,0,1655,0,19,19
1330067,1328575,1492,0,1444,48,20,20
1318575,1316648,1927,0,1846,81,20,20
1334641,1332995,1646,139,1507,0,19,20
1333212,1330894,2318,0,2318,0,19,19
1319753,1317972,1781,0,1781,0,19,19
1303082,1301444,1638,0,1572,66,20,20
1302848,1301581,1267,0,1267,0,19,19
1329680,1327865,1815,0,1741,74,20,20
1328093,1326081,2012,0,2012,0,19,19
1219108,1217560,1548,0,1548,0,19,19
1271757,1270047,1710,0,1574,136,20,20
1265782,1264087,1695,55,1640,0,19,20
1271667,1269792,1875,0,1760,115,20,20
1237042,1235682,1360,0,1360,0,19,19
1249048,1247389,1659,0,1659,0,19,19
1216015,1215057,958,56,902,0,15,16
811050,810178,872,0,872,0,19,19
817486,816324,1162,61,1101,0,19,20
829919,828891,1028,0,1028,0,19,19
834841,833882,959,0,959,0,19,19
839244,838127,1117,49,1068,0,19,20
823584,822657,927,0,927,0,19,19
830035,829090,945,0,945,0,19,19
831258,830063,1195,0,1195,0,19,19
827745,826686,1059,0,1001,58,20,20
809361,808307,1054,0,1054,0,19,19
802036,801112,924,0,924,0,19,19
804775,803854,921,0,851,70,20,20
802576,801689,887,0,887,0,19,19
791273,790138,1135,0,1092,43,20,20
799214,798212,1002,38,964,0,19,20
802311,801342,969,0,935,34,20,20
796534,795581,953,0,953,0,19,19
784685,783725,960,32,928,0,19,20
752625,751885,740,0,740,0,19,19
761781,760896,885,59,826,0,19,20
760820,759652,1168,36,1132,0,19,20
758334,757607,727,0,694,33,20,20
766211,765479,732,34,698,0,19,20
765651,764697,954,0,954,0,19,19
772428,771406,1022,0,1022,0,19,19
777300,776263,1037,0,1037,0,19,19
773873,773011,862,0,862,0,19,19
766061,765159,902,0,902,0,19,19
757052,756106,946,0,946,0,19,19
743338,742461,877,0,877,0,19,19
733096,732256,840,0,840,0,19,19
726828,725573,1255,0,1255,0,19,19
719846,718576,1270,0,1270,0,19,19
705407,704480,927,0,927,0,19,19
690730,689658,1072,42,1030,0,19,20
689056,688136,920,0,920,0,19,19
673430,672490,940,0,940,0,19,19
685195,684495,700,0,700,0,19,19
684702,683526,1176,0,1176,0,19,19
668549,667740,809,0,809,0,19,19
658204,657408,796,0,796,0,19,19
650352,649653,699,0,684,15,20,20
637697,636889,808,0,779,29,20,20
631222,630798,424,0,424,0,19,19
625657,625229,428,0,428,0,19,19
615934,615282,652,0,652,0,19,19
615245,614391,854,14,840,0,19,20
612584,611285,1299,0,1181,118,20,20
610033,609241,792,0,792,0,19,19
603638,602854,784,0,784,0,19,19
609253,608485,768,0,768,0,19,19
611981,611291,690,0,656,34,20,20
613074,612179,895,0,895,0,19,19
595334,594819,515,0,515,0,18,18
597932,597318,614,32,582,0,19,20
589850,589153,697,0,697,0,19,19
580718,579892,826,0,782,44,20,20
575963,574934,1029,0,1029,0,19,19
556471,555635,836,0,836,0,19,19
561189,560308,881,0,881,0,19,19
554510,553572,938,34,904,0,19,20
558212,557484,728,0,728,0,19,19
546129,545173,956,0,896,60,20,20
545854,545065,789,0,789,0,19,19
542212,541427,785,0,754,31,20,20
537258,536326,932,0,886,46,20,20
528689,527867,822,34,788,0,19,20
538480,537551,929,0,895,34,20,20
542148,541334,814,0,772,42,20,20
539729,538916,813,0,776,37,20,20
543196,542460,736,0,736,0,19,19
538257,537507,750,40,710,0,19,20
548248,547304,944,50,894,0,19,20
551413,550672,741,0,704,37,20,20
553286,552446,840,0,803,37,20,20
553118,552418,700,32,668,0,19,20
553387,552707,680,0,680,0,19,19
549586,548850,736,0,694,42,20,20
549796,549059,737,33,704,0,19,20
554420,553540,880,44,836,0,19,20
548368,547650,718,0,718,0,19,19
540686,540013,673,0,673,0,19,19
541867,541115,752,0,752,0,19,19
549075,548434,641,0,641,0,19,19
551791,551117,674,32,642,0,19,20
552160,551307,853,0,809,44,20,20
545420,544724,696,0,696,0,19,19
539224,538618,606,0,606,0,18,18
546689,546017,672,0,672,0,19,19
550956,550217,739,0,739,0,19,19
549485,548869,616,0,616,0,19,19
539093,538474,619,0,619,0,19,19
537910,537231,679,0,679,0,19,19
529569,528881,688,43,645,0,19,20
528393,527646,747,44,703,0,19,20
535788,535171,617,0,617,0,19,19
541239,540455,784,0,757,27,20,20
537263,536612,651,0,651,0,19,19
531397,530814,583,0,583,0,19,19
531145,530461,684,0,684,0,19,19
530184,529563,621,0,621,0,19,19
525922,525321,601,0,601,0,19,19
525992,525357,635,0,635,0,19,19
529722,529042,680,0,635,45,20,20
527863,527192,671,0,671,0,19,19
521787,521060,727,0,727,0,19,19
520428,519761,667,0,667,0,19,19
519036,518433,603,0,603,0,19,19
516126,515358,768,0,722,46,20,20
505873,505333,540,0,540,0,19,19
504799,504146,653,0,633,20,20,20
503277,502610,667,0,667,0,19,19
496758,496198,560,0,560,0,19,19
501531,500906,625,0,625,0,19,19
501598,500809,789,0,789,0,19,19
499462,498701,761,0,761,0,19,19
496122,495288,834,0,834,0,19,19
498424,497820,604,36,568,0,19,20
493447,492646,801,0,801,0,19,19
488237,487403,834,23,811,0,19,20
488218,487521,697,9,688,0,19,20
490168,489355,813,0,813,0,19,19
489885,489107,778,7,771,0,19,20
477187,476391,796,0,738,58,20,20
477525,477000,525,0,525,0,19,19
483572,483033,539,0,539,0,19,19
489266,488499,767,0,767,0,19,19
486528,485863,665,0,665,0,19,19
476677,475905,772,0,722,50,20,20
478664,477969,695,0,695,0,19,19
476810,476184,626,0,626,0,19,19
483149,482584,565,0,541,24,20,20
488108,487413,695,0,695,0,19,19
484414,483763,651,0,651,0,19,19
487650,487179,471,0,471,0,19,19
495019,494583,436,0,421,15,20,20
484991,484144,847,0,804,43,20,20
490905,490146,759,0,759,0,19,19
492994,492338,656,27,629,0,19,20
497575,496838,737,0,737,0,19,19
493159,492452,707,0,707,0,19,19
495900,495214,686,0,686,0,19,19
489862,489087,775,0,775,0,19,19
490276,489488,788,0,788,0,19,19
483436,482694,742,26,716,0,19,20
478742,478118,624,0,624,0,19,19
484646,483846,800,0,800,0,19,19
489002,488445,557,0,557,0,19,19
491696,491085,611,0,611,0,19,19
491359,490676,683,0,655,28,20,20
487781,487187,594,0,594,0,19,19
495323,494708,615,0,615,0,19,19
498098,497319,779,0,746,33,20,20
498483,497834,649,0,630,19,20,20
497026,496376,650,0,650,0,19,19
491380,490778,602,0,602,0,19,19
502342,501690,652,40,612,0,19,20
507489,506874,615,29,586,0,19,20
514931,514079,852,0,831,21,20,20
512349,511570,779,0,726,53,20,20
517803,517151,652,31,621,0,19,20
521442,520806,636,18,618,0,19,20
524292,523623,669,0,652,17,20,20
527375,526693,682,0,682,0,19,19
528121,527337,784,0,754,30,20,20
525011,524291,720,0,720,0,19,19
508958,508264,694,2,692,0,19,20
524085,523586,499,0,499,0,19,19
529929,529165,764,22,742,0,19,20
531344,530602,742,0,720,22,20,20
524692,523946,746,0,727,19,20,20
534758,534097,661,23,638,0,19,20
538967,538297,670,46,624,0,19,20
534936,533917,1019,0,960,59,20,20
524677,524080,597,0,597,0,19,19
534607,533928,679,61,618,0,19,20
544444,543811,633,0,633,0,19,19
544617,543976,641,0,641,0,19,19
544794,544079,715,0,715,0,19,19
547781,547174,607,0,607,0,19,19
544500,543722,778,17,761,0,19,20
543217,542645,572,0,572,0,19,19
546594,545864,730,27,703,0,19,20
554500,553889,611,0,611,0,19,19
555356,554751,605,0,605,0,19,19
556513,555778,735,0,714,21,20,20
560236,559611,625,0,584,41,20,20
557852,557116,736,21,715,0,19,20
547817,546994,823,0,823,0,19,19
556784,556059,725,0,725,0,19,19
556007,555334,673,0,673,0,19,19
560799,560092,707,0,707,0,19,19
563604,562839,765,30,735,0,19,20
566348,565630,718,0,718,0,19,19
561215,560461,754,0,754,0,19,19
566571,565843,728,0,693,35,20,20
568636,567984,652,0,652,0,19,19
565152,564546,606,0,606,0,19,19
569991,569166,825,0,825,0,19,19
561473,560586,887,68,819,0,19,20
555195,554520,675,0,675,0,19,19
556919,556265,654,33,621,0,19,20
561466,560684,782,0,782,0,19,19
561658,561094,564,0,564,0,19,19
557438,556757,681,0,681,0,19,19
558782,557977,805,0,805,0,19,19
545666,544877,789,9,780,0,19,20
547363,546671,692,55,637,0,19,20
551639,550835,804,0,804,0,19,19
547948,547152,796,0,796,0,19,19
545457,544251,1206,81,1125,0,19,20
542596,541848,748,0,748,0,19,19
539546,538913,633,29,604,0,19,20
537128,536387,741,0,712,29,20,20
532389,531832,557,0,557,0,19,19
528834,528206,628,0,628,0,19,19
540858,540314,544,0,512,32,20,20
549726,549184,542,15,527,0,19,20
552613,551857,756,0,735,21,20,20
551423,550540,883,0,883,0,19,19
553023,552196,827,0,776,51,20,20
550150,549381,769,0,769,0,19,19
536879,536101,778,0,778,0,19,19
536508,535755,753,0,753,0,19,19
540509,539601,908,0,908,0,19,19
545651,544750,901,0,901,0,19,19
550042,549248,794,0,729,65,20,20
553008,552281,727,27,700,0,19,20
555632,554884,748,0,717,31,20,20
551050,550307,743,0,743,0,19,19
532195,531323,872,0,872,0,19,19
533015,532334,681,34,647,0,19,20
530496,529797,699,0,699,0,19,19
537214,536448,766,34,732,0,19,20
533629,532810,819,0,819,0,19,19
531670,530815,855,0,793,62,20,20
533092,532349,743,0,743,0,19,19
534147,533551,596,0,596,0,19,19
533216,532495,721,0,679,42,20,20
530836,530004,832,0,832,0,19,19
522499,521715,784,0,784,0,19,19
510040,509277,763,0,763,0,19,19
518313,517765,548,0,548,0,19,19
522129,521567,562,0,562,0,19,19
512451,511727,724,0,724,0,19,19
509290,508577,713,0,713,0,19,19
503190,502470,720,0,720,0,19,19
494277,493474,803,0,764,39,20,20
494418,493821,597,0,597,0,19,19
491153,490481,672,0,672,0,19,19
487217,486554,663,0,663,0,19,19
486149,485619,530,0,530,0,19,19
494954,494267,687,0,659,28,20,20
496629,495946,683,0,683,0,19,19
486664,486151,513,0,513,0,19,19
488708,487825,883,0,808,75,20,20
474029,473349,680,0,680,0,19,19
471163,470589,574,0,574,0,19,19
467076,466438,638,0,599,39,20,20
468303,467717,586,0,586,0,19,19
463160,462700,460,8,452,0,19,20
474262,473480,782,0,771,11,20,20
464936,464279,657,0,657,0,19,19
477475,476560,915,0,874,41,20,20
485370,484775,595,0,595,0,19,19
481913,481186,727,9,718,0,19,20
471648,471132,516,0,516,0,19,19
466965,466292,673,0,641,32,20,20
462116,461586,530,0,530,0,19,19
480111,479489,622,26,596,0,19,20
476527,475791,736,0,710,26,20,20
485426,484681,745,0,685,60,20,20
486597,486044,553,0,553,0,19,19
477079,476373,706,0,674,32,20,20
485718,485125,593,0,593,0,19,19
474004,473385,619,7,612,0,19,20
476777,476199,578,0,578,0,19,19
477654,476946,708,23,685,0,19,20
469092,468543,549,11,538,0,19,20
490594,489790,804,0,738,66,20,20
496693,496071,622,0,597,25,20,20
491444,490927,517,21,496,0,19,20
491564,491103,461,0,461,0,19,19
499951,499335,616,20,596,0,19,20
509346,508598,748,50,698,0,19,20
509981,509243,738,0,709,29,20,20
509899,509130,769,45,724,0,19,20
519412,518642,770,0,770,0,19,19
527418,526755,663,0,663,0,19,19
529784,529178,606,0,606,0,19,19
539523,538779,744,0,744,0,19,19
539960,539357,603,0,603,0,19,19
548418,547689,729,0,699,30,20,20
559083,558572,511,0,511,0,19,19
558788,558120,668,41,627,0,19,20
564769,563998,771,0,771,0,19,19
569130,568768,362,0,362,0,19,19
566567,566152,415,38,377,0,19,20
560260,559765,495,0,473,22,20,20
561982,561132,850,58,792,0,19,20
559459,558598,861,0,861,0,19,19
565174,564212,962,0,962,0,19,19
554681,553512,1169,0,1104,65,20,20
559608,558748,860,0,813,47,20,20
571113,570328,785,41,744,0,19,20
571989,571075,914,0,914,0,19,19
581365,580656,709,40,669,0,19,20
579636,578657,979,0,979,0,19,19
573128,572332,796,0,796,0,19,19
569843,569095,748,0,718,30,20,20
574985,574196,789,0,736,53,20,20
574141,573237,904,0,904,0,19,19
578982,578306,676,0,676,0,19,19
578526,577660,866,0,866,0,19,19
571667,570847,820,0,820,0,19,19
584117,583306,811,0,811,0,19,19
583931,582954,977,46,931,0,19,20
579048,578213,835,0,835,0,19,19
581295,580578,717,0,682,35,20,20
581376,580711,665,0,665,0,19,19
575360,574532,828,0,828,0,19,19
577516,576889,627,33,594,0,19,20
579397,578580,817,0,770,47,20,20
582520,581769,751,0,751,0,19,19
583802,583086,716,0,716,0,19,19
585514,584743,771,0,734,37,20,20
585403,584707,696,0,696,0,19,19
573922,573038,884,0,884,0,19,19
575745,574729,1016,44,972,0,19,20
580883,580227,656,0,624,32,20,20
576004,575323,681,0,681,0,19,19
566746,565828,918,36,882,0,19,20
563059,562311,748,52,696,0,19,20
566714,565933,781,0,738,43,20,20
560856,559866,990,0,990,0,19,19
555895,554892,1003,0,1003,0,19,19
563171,562458,713,0,713,0,19,19
566880,566195,685,64,621,0,19,20
569709,568991,718,0,718,0,19,19
572531,571703,828,0,781,47,20,20
571291,570389,902,0,902,0,19,19
572321,571520,801,0,801,0,19,19
575356,574758,598,0,598,0,19,19
574803,574140,663,0,663,0,19,19
573936,573169,767,45,722,0,19,20
569568,568765,803,0,771,32,20,20
568822,568146,676,0,676,0,19,19
570922,570251,671,12,659,0,19,20
576696,575937,759,0,759,0,19,19
568032,567241,791,0,724,67,20,20
567071,566318,753,0,753,0,19,19
557919,557241,678,0,678,0,19,19
561319,560614,705,0,705,0,19,19
549766,549024,742,34,708,0,19,20
551256,550382,874,41,833,0,19,20
548876,548176,700,36,664,0,19,20
546322,545562,760,0,760,0,19,19
540754,539994,760,0,760,0,19,19
534517,533760,757,43,714,0,19,20
535805,535095,710,0,710,0,19,19
543570,542818,752,0,752,0,19,19
542865,541988,877,0,877,0,19,19
537559,536781,778,0,778,0,19,19
525084,524322,762,0,762,0,19,19
523977,523209,768,26,742,0,19,20
529161,528566,595,0,556,39,20,20
539262,538265,997,0,997,0,19,19
531747,530790,957,0,957,0,19,19
531393,530384,1009,0,1009,0,19,19
533200,532322,878,42,836,0,19,20
533746,533275,471,0,471,0,19,19
526967,526062,905,0,905,0,19,19
516006,514677,1329,40,1289,0,19,20
512984,511934,1050,51,999,0,19,20
512359,511256,1103,59,1044,0,19,20
516031,515145,886,0,886,0,19,19
517697,516649,1048,0,998,50,20,20
517329,516283,1046,0,996,50,20,20
519928,519004,924,24,900,0,19,20
519636,518811,825,0,825,0,19,19
522850,522069,781,15,766,0,19,20
527251,526434,817,59,758,0,19,20
531633,530661,972,0,945,27,20,20
530104,529253,851,0,803,48,20,20
535729,534809,920,61,859,0,19,20
531289,530401,888,37,851,0,19,20
538193,537148,1045,0,1045,0,19,19
537378,536405,973,0,973,0,19,19
546504,545546,958,0,958,0,19,19
541045,540137,908,0,908,0,19,19
543574,542636,938,0,938,0,19,19
545795,545037,758,0,758,0,19,19
549561,548583,978,0,978,0,19,19
551149,550328,821,0,821,0,19,19
554764,553770,994,0,994,0,19,19
554547,553570,977,0,924,53,20,20
557225,556121,1104,0,1073,31,20,20
556165,555241,924,0,924,0,19,19
555075,554251,824,0,824,0,19,19
558870,557852,1018,0,1018,0,19,19
558360,557478,882,0,845,37,20,20
561728,560751,977,0,941,36,20,20
557980,556963,1017,0,1017,0,19,19
558679,557797,882,0,882,0,19,19
549283,548365,918,0,918,0,19,19
547098,546225,873,0,873,0,19,19
548753,547781,972,67,905,0,19,20
549960,549156,804,0,804,0,19,19
548163,547140,1023,0,1023,0,19,19
543037,542158,879,0,879,0,19,19
534505,533628,877,0,877,0,19,19
541391,540643,748,0,748,0,19,19
538494,537767,727,0,727,0,19,19
537626,536673,953,0,903,50,20,20
535378,534646,732,0,732,0,19,19
519409,518773,636,0,636,0,19,19
523931,523187,744,34,710,0,19,20
519147,518312,835,43,792,0,19,20
522277,521522,755,0,755,0,19,19
525360,524530,830,0,830,0,19,19
521334,520221,1113,0,1088,25,20,20
512818,511927,891,0,891,0,19,19
508588,507806,782,0,782,0,19,19
513327,512390,937,34,903,0,19,20
512428,511494,934,50,884,0,19,20
504898,503942,956,0,956,0,19,19
503996,503116,880,0,880,0,19,19
504558,503823,735,0,735,0,19,19
511057,510252,805,0,805,0,19,19
504110,503315,795,0,795,0,19,19
495770,495003,767,0,767,0,19,19
499391,498562,829,0,829,0,19,19
492832,492031,801,0,801,0,19,19
498671,497750,921,0,921,0,19,19
497342,496573,769,59,710,0,19,20
494168,493372,796,0,723,73,20,20
491741,491010,731,0,706,25,20,20
494863,494092,771,0,740,31,20,20
493413,492571,842,0,842,0,19,19
495335,494526,809,0,809,0,19,19
505935,504829,1106,80,1026,0,19,20
500759,499871,888,0,888,0,19,19
502079,501213,866,0,866,0,19,19
498689,497866,823,53,770,0,19,20
500665,499874,791,0,791,0,19,19
488434,487661,773,0,773,0,19,19
497180,496491,689,0,689,0,19,19
495726,494645,1081,52,1029,0,19,20
494261,493369,892,0,892,0,19,19
493042,492181,861,55,806,0,19,20
490615,489965,650,0,650,0,19,19
491208,490500,708,0,708,0,19,19
492743,492045,698,0,698,0,19,19
491730,490925,805,0,805,0,19,19
489632,489027,605,36,569,0,19,20
492449,491725,724,0,724,0,19,19
490299,489709,590,0,590,0,19,19
493222,492619,603,0,603,0,19,19
497593,496936,657,0,657,0,19,19
496164,495464,700,0,700,0,19,19
502005,501040,965,0,925,40,20,20
512246,511470,776,36,740,0,19,20
512969,512286,683,0,683,0,19,19
512214,511463,751,33,718,0,19,20
505785,504908,877,36,841,0,19,20
504438,503713,725,0,725,0,19,19
511049,510267,782,41,741,0,19,20
516086,515357,729,0,729,0,19,19
508335,507537,798,35,763,0,19,20
514868,514031,837,37,800,0,19,20
519250,518577,673,0,673,0,19,19
526074,525309,765,0,765,0,19,19
528510,527799,711,0,711,0,19,19
526669,525950,719,0,719,0,19,19
528304,527372,932,0,932,0,19,19
525222,524057,1165,0,1165,0,19,19
523392,522559,833,0,833,0,19,19
526721,525776,945,0,878,67,20,20
534815,533959,856,0,856,0,19,19
534240,533090,1150,0,1150,0,19,19
546550,545596,954,55,899,0,19,20
551737,550642,1095,0,1095,0,19,19
551128,549961,1167,0,1108,59,20,20
556070,555111,959,49,910,0,19,20
555611,554718,893,0,893,0,19,19
561935,560956,979,0,979,0,19,19
564766,563965,801,0,801,0,19,19
586742,585614,1128,0,1128,0,19,19
596497,595397,1100,0,1100,0,19,19
601460,600458,1002,0,1002,0,19,19
615045,613887,1158,0,1158,0,19,19
623479,622194,1285,0,1285,0,19,19
637835,636857,978,0,978,0,19,19
639258,637976,1282,39,1243,0,19,20
648077,647192,885,0,885,0,19,19
644956,643724,1232,0,1232,0,19,19
657701,656678,1023,0,1023,0,19,19
668538,667729,809,0,809,0,19,19
682881,681819,1062,0,1062,0,19,19
673608,672832,776,0,776,0,19,19
667325,666338,987,0,959,28,20,20
662702,661882,820,0,820,0,19,19
673612,672545,1067,0,1067,0,19,19
670624,669768,856,0,856,0,19,19
667586,666807,779,0,779,0,19,19
677084,676358,726,0,726,0,19,19
688820,688144,676,0,676,0,19,19
699752,698655,1097,0,1017,80,20,20
706617,705606,1011,0,1011,0,19,19
698415,697524,891,0,891,0,19,19
705420,704381,1039,0,1039,0,19,19
707682,706739,943,0,943,0,19,19
707140,706123,1017,45,972,0,19,20
725759,724719,1040,0,993,47,20,20
748429,747663,766,0,766,0,19,19
751887,750745,1142,0,1142,0,19,19
740099,739060,1039,0,1039,0,19,19
742971,742102,869,0,869,0,19,19
746206,745190,1016,0,1016,0,19,19
763848,762971,877,0,837,40,20,20
774537,773677,860,0,860,0,19,19
781147,780088,1059,0,1059,0,19,19
796003,794809,1194,0,1194,0,19,19
801937,800797,1140,66,1074,0,19,20
800774,799526,1248,86,1162,0,19,20
810768,809680,1088,0,1088,0,19,19
824505,823605,900,0,900,0,19,19
840942,839945,997,0,997,0,19,19
852899,851671,1228,52,1176,0,19,20
853222,851850,1372,0,1309,63,20,20
857380,856215,1165,59,1106,0,19,20
872979,871356,1623,77,1546,0,19,20
886561,885239,1322,0,1322,0,19,19
888909,887509,1400,0,1400,0,19,19
910280,909023,1257,35,1222,0,19,20
911849,910410,1439,0,1439,0,19,19
902427,900989,1438,0,1438,0,19,19
905718,904435,1283,0,1226,57,20,20
912749,911258,1491,0,1491,0,19,19
911749,910449,1300,0,1300,0,19,19
932376,930745,1631,152,1479,0,19,20
928874,927488,1386,0,1343,43,20,20
932314,930558,1756,0,1706,50,20,20
944175,942360,1815,0,1815,0,19,19
1319390,1317798,1592,0,1592,0,13,13
1331198,1329212,1986,134,1852,0,19,20
1341085,1339488,1597,0,1597,0,19,19
1384704,1381892,2812,124,2688,0,19,20
1368068,1366007,2061,0,1873,188,20,20
1409629,1407675,1954,0,1954,0,19,19
1410002,1407368,2634,0,2634,0,19,19
1410135,1406598,3537,0,3537,0,19,19
1408436,1406379,2057,78,1979,0,19,20
1429199,1426698,2501,0,2387,114,20,20
1403537,1400406,3131,0,3131,0,19,19
1411060,1408826,2234,196,2038,0,19,20
1417878,1415512,2366,0,2366,0,19,19
1413954,1411234,2720,0,2720,0,19,19
1416466,1414119,2347,0,2347,0,19,19
1424475,1422386,2089,0,2089,0,19,19
1401898,1399185,2713,0,2713,0,19,19
1408190,1404902,3288,0,3288,0,19,19
1436148,1433722,2426,0,2267,159,20,20
