coverage,wt.counts,mut.count,s.count,ns.count,stp.count,aa.sampled,codons.sampled
1444479,1442566,1913,0,1913,0,19,19
1441271,1439182,2089,0,2089,0,19,19
1435569,1434013,1556,0,1556,0,19,19
1439117,1436994,2123,0,2123,0,19,19
1430726,1428373,2353,0,2353,0,19,19
1424542,1422458,2084,0,2084,0,19,19
1430901,1429016,1885,0,1885,0,19,19
1402323,1400546,1777,0,1777,0,19,19
1438740,1436767,1973,0,1973,0,19,19
1419472,1417043,2429,0,2328,101,20,20
1408734,1406772,1962,0,1857,105,20,20
1427317,1425255,2062,93,1969,0,19,20
1434326,1432554,1772,0,1772,0,19,19
1413915,1412084,1831,0,1831,0,19,19
1397009,1395236,1773,0,1667,106,20,20
1407589,1405988,1601,0,1601,0,19,19
1431478,1429703,1775,0,1708,67,20,20
1433517,1431551,1966,0,1966,0,19,19
1351474,1349654,1820,0,1820,0,19,19
1382213,1380344,1869,0,1807,62,20,20
1375200,1373126,2074,83,1991,0,19,20
1380063,1378260,1803,0,1682,121,20,20
1352931,1351078,1853,0,1853,0,19,19
1364088,1362292,1796,0,1796,0,19,19
1326285,1325069,1216,123,1093,0,13,14
928863,927687,1176,0,1176,0,19,19
938625,937207,1418,72,1346,0,19,20
950088,948796,1292,0,1292,0,19,19
953630,952399,1231,0,1231,0,19,19
953948,952618,1330,83,1247,0,19,20
937076,935736,1340,0,1340,0,19,19
943487,942241,1246,0,1246,0,19,19
944217,943082,1135,0,1135,0,19,19
940071,938724,1347,0,1239,108,20,20
917674,916438,1236,0,1236,0,19,19
906367,905269,1098,0,1098,0,19,19
905152,903943,1209,0,1112,97,20,20
902552,901210,1342,0,1342,0,19,19
889442,888062,1380,0,1306,74,20,20
895717,894460,1257,49,1208,0,19,20
896513,895243,1270,0,1194,76,20,20
887525,886529,996,0,996,0,19,19
870213,869115,1098,51,1047,0,19,20
838461,837499,962,0,962,0,19,19
844236,843287,949,51,898,0,19,20
769173,767871,1302,70,1232,0,19,20
834962,833832,1130,0,1088,42,20,20
842246,841321,925,24,901,0,19,20
839020,837956,1064,0,1064,0,19,19
845342,844105,1237,0,1237,0,19,19
847760,846495,1265,0,1265,0,19,19
842587,841423,1164,0,1164,0,19,19
831498,830354,1144,0,1144,0,19,19
819872,818778,1094,0,1094,0,19,19
802565,801462,1103,0,1103,0,19,19
791543,790543,1000,0,1000,0,19,19
783721,782600,1121,0,1121,0,19,19
773911,772832,1079,0,1079,0,19,19
758598,757712,886,0,886,0,19,19
739275,738247,1028,51,977,0,19,20
735323,734361,962,0,962,0,19,19
719420,718368,1052,0,1052,0,19,19
729432,728660,772,0,772,0,19,19
725852,724797,1055,0,1055,0,19,19
707955,706925,1030,0,1030,0,19,19
695823,695020,803,0,803,0,19,19
687179,686255,924,0,891,33,20,20
675773,674843,930,0,861,69,20,20
668085,667394,691,0,691,0,19,19
661063,660591,472,0,472,0,19,19
651029,650229,800,0,800,0,19,19
650127,649275,852,36,816,0,19,20
646643,645554,1089,0,1020,69,20,20
643771,642929,842,0,842,0,19,19
638703,637799,904,0,904,0,19,19
644294,643533,761,0,761,0,19,19
649544,648611,933,0,886,47,20,20
651978,651162,816,0,816,0,19,19
635050,634270,780,0,780,0,18,18
637889,637047,842,52,790,0,19,20
629162,628374,788,0,788,0,19,19
619187,618322,865,0,842,23,20,20
614963,614118,845,0,845,0,19,19
595474,594630,844,0,844,0,19,19
601719,600920,799,0,799,0,19,19
596499,595509,990,44,946,0,19,20
599438,598578,860,0,860,0,19,19
587384,586538,846,0,793,53,20,20
589342,588588,754,0,754,0,19,19
585643,584706,937,0,893,44,20,20
581338,580459,879,0,844,35,20,20
573837,572977,860,49,811,0,19,20
586530,585465,1065,0,1033,32,20,20
591271,590370,901,0,860,41,20,20
590655,589699,956,0,910,46,20,20
593544,592877,667,0,667,0,19,19
591441,590574,867,42,825,0,19,20
601093,600067,1026,37,989,0,19,20
606743,605866,877,0,833,44,20,20
609308,608293,1015,0,976,39,20,20
610567,609756,811,24,787,0,19,20
611783,610933,850,0,850,0,19,19
609979,609205,774,0,752,22,20,20
610768,609866,902,28,874,0,19,20
616365,615331,1034,76,958,0,19,20
610466,609586,880,0,880,0,19,19
602872,602057,815,0,815,0,19,19
604792,603938,854,0,854,0,19,19
613380,612617,763,0,763,0,19,19
616090,615326,764,36,728,0,19,20
616762,615739,1023,0,967,56,20,20
609223,608350,873,0,873,0,19,19
604656,603855,801,0,801,0,19,19
611992,611160,832,0,832,0,19,19
617041,616197,844,0,844,0,19,19
617012,616221,791,0,791,0,19,19
605692,604909,783,0,783,0,19,19
605619,604683,936,0,936,0,19,19
596769,595863,906,82,824,0,19,20
595720,594734,986,49,937,0,19,20
603120,602354,766,0,766,0,19,19
608474,607515,959,0,916,43,20,20
604857,604056,801,0,801,0,19,19
599144,598369,775,0,775,0,19,19
599348,598496,852,0,852,0,19,19
597799,597018,781,0,781,0,19,19
594215,593395,820,0,820,0,19,19
593272,592375,897,0,897,0,19,19
597561,596745,816,0,790,26,20,20
596195,595425,770,0,770,0,19,19
588385,587564,821,0,821,0,19,19
587307,586487,820,0,820,0,19,19
585377,584574,803,0,803,0,19,19
582515,581506,1009,0,944,65,20,20
572027,571181,846,0,846,0,19,19
568861,568019,842,0,820,22,20,20
567228,566352,876,0,876,0,19,19
560762,560052,710,0,710,0,19,19
565138,564408,730,0,730,0,19,19
565289,564486,803,0,803,0,19,19
563616,562827,789,0,789,0,19,19
560093,559291,802,0,802,0,19,19
562821,562031,790,31,759,0,19,20
556550,555696,854,0,854,0,19,19
551574,550767,807,47,760,0,19,20
550503,549702,801,49,752,0,19,20
553171,552299,872,0,872,0,19,19
553426,552628,798,40,758,0,19,20
543230,542314,916,0,864,52,20,20
539241,538550,691,0,691,0,19,19
545921,545240,681,0,681,0,19,19
552311,551439,872,0,872,0,19,19
549879,549087,792,0,792,0,19,19
540262,539461,801,0,759,42,20,20
538309,537633,676,0,676,0,19,19
535592,534953,639,0,639,0,19,19
541428,540900,528,0,503,25,20,20
548071,547341,730,0,730,0,19,19
544038,543443,595,0,595,0,19,19
545793,545287,506,0,506,0,19,19
553342,552809,533,0,517,16,20,20
545209,544322,887,0,847,40,20,20
548912,548158,754,0,754,0,19,19
551937,551201,736,30,706,0,19,20
555761,554963,798,0,798,0,19,19
550643,549906,737,0,737,0,19,19
553302,552561,741,0,741,0,19,19
546075,545308,767,0,767,0,19,19
546236,545552,684,0,684,0,19,19
537631,536835,796,44,752,0,19,20
534535,533935,600,0,600,0,19,19
539379,538611,768,0,768,0,19,19
544233,543547,686,0,686,0,19,19
548901,548091,810,0,810,0,19,19
548270,547483,787,0,749,38,20,20
542533,541798,735,0,735,0,19,19
550962,550223,739,0,739,0,19,19
552675,551978,697,0,672,25,20,20
553433,552563,870,0,827,43,20,20
551595,550920,675,0,675,0,19,19
545145,544382,763,0,763,0,19,19
556739,555972,767,45,722,0,19,20
561702,560960,742,43,699,0,19,20
570763,569797,966,0,899,67,20,20
569890,568887,1003,0,933,70,20,20
573712,572890,822,40,782,0,19,20
576406,575673,733,39,694,0,19,20
578646,577866,780,0,741,39,20,20
582722,581961,761,0,761,0,19,19
582131,581167,964,0,926,38,20,20
578744,577965,779,0,779,0,19,19
562645,561960,685,10,675,0,19,20
577113,576406,707,0,707,0,19,19
583912,583103,809,54,755,0,19,20
585995,585171,824,0,793,31,20,20
578666,577734,932,0,917,15,20,20
589075,588192,883,35,848,0,19,20
593328,592466,862,46,816,0,19,20
588460,587326,1134,0,1075,59,20,20
580401,579687,714,0,714,0,19,19
587176,586295,881,79,802,0,19,20
598484,597665,819,0,819,0,19,19
599861,599071,790,0,790,0,19,19
599128,598237,891,0,891,0,19,19
601092,600234,858,0,858,0,19,19
597112,596267,845,28,817,0,19,20
597491,596816,675,0,675,0,19,19
599255,598487,768,34,734,0,19,20
608450,607741,709,0,709,0,19,19
609448,608743,705,0,705,0,19,19
609403,608599,804,0,774,30,20,20
612634,611862,772,0,743,29,20,20
609862,608958,904,42,862,0,19,20
602870,602059,811,0,811,0,19,19
607906,607106,800,0,800,0,19,19
607651,606882,769,0,769,0,19,19
613190,612377,813,0,813,0,19,19
615989,615140,849,39,810,0,19,20
618453,617696,757,0,757,0,19,19
612828,612102,726,0,726,0,19,19
618347,617520,827,0,791,36,20,20
619811,619045,766,0,766,0,19,19
616650,615956,694,0,694,0,19,19
620987,620123,864,0,864,0,19,19
612465,611608,857,69,788,0,19,20
608725,607903,822,0,822,0,19,19
608811,608017,794,48,746,0,19,20
612255,611422,833,0,833,0,19,19
613568,612775,793,0,793,0,19,19
608880,608168,712,0,712,0,19,19
609967,609125,842,0,842,0,19,19
597335,596620,715,38,677,0,19,20
599397,598732,665,31,634,0,19,20
604645,603867,778,0,778,0,19,19
599302,598497,805,0,805,0,19,19
596827,595727,1100,30,1070,0,19,20
593485,592644,841,0,841,0,19,19
590090,589445,645,28,617,0,19,20
587655,586741,914,0,876,38,20,20
582372,581782,590,0,590,0,19,19
578819,578071,748,0,748,0,19,19
590871,590302,569,0,534,35,20,20
598656,598021,635,23,612,0,19,20
603369,602549,820,0,791,29,20,20
601147,600289,858,0,858,0,19,19
602026,601173,853,0,810,43,20,20
598971,598190,781,0,781,0,19,19
585207,584419,788,0,788,0,19,19
583834,583068,766,0,766,0,19,19
587255,586493,762,0,762,0,19,19
593425,592700,725,0,725,0,19,19
597080,596234,846,0,782,64,20,20
602910,602118,792,28,764,0,19,20
605286,604579,707,0,677,30,20,20
600478,599696,782,0,782,0,19,19
581578,580769,809,0,809,0,19,19
581836,581090,746,44,702,0,19,20
579936,579219,717,0,717,0,19,19
587948,587308,640,45,595,0,19,20
582611,581910,701,0,701,0,19,19
580603,579772,831,0,784,47,20,20
583063,582317,746,0,746,0,19,19
583327,582655,672,0,672,0,19,19
582151,581469,682,0,638,44,20,20
580061,579337,724,0,724,0,19,19
570883,570146,737,0,737,0,19,19
558496,557767,729,0,729,0,19,19
569053,568454,599,0,599,0,19,19
571623,571043,580,0,580,0,19,19
561686,560933,753,0,753,0,19,19
558125,557461,664,0,664,0,19,19
553743,552987,756,0,756,0,19,19
546409,545626,783,0,734,49,20,20
542695,542073,622,0,622,0,19,19
539565,538864,701,0,701,0,19,19
537720,537123,597,0,597,0,19,19
536311,535709,602,0,602,0,19,19
546330,545546,784,0,750,34,20,20
549132,548495,637,0,637,0,19,19
539905,539318,587,0,587,0,19,19
543068,542205,863,0,825,38,20,20
530864,530303,561,0,561,0,19,19
525323,524685,638,0,638,0,19,19
521301,520553,748,0,712,36,20,20
526271,525616,655,0,655,0,19,19
522796,522226,570,17,553,0,19,20
532844,532142,702,0,696,6,20,20
525469,524777,692,0,692,0,19,19
539330,538440,890,0,854,36,20,20
546877,546276,601,0,601,0,19,19
544258,543600,658,28,630,0,19,20
535456,534898,558,0,558,0,19,19
528311,527632,679,0,647,32,20,20
525003,524383,620,0,620,0,19,19
541836,541113,723,33,690,0,19,20
540088,539473,615,0,589,26,20,20
548764,547971,793,0,753,40,20,20
552612,551995,617,0,617,0,19,19
542463,541806,657,0,628,29,20,20
550498,549909,589,0,589,0,19,19
547226,546561,665,29,636,0,19,20
545242,544573,669,0,669,0,19,19
544225,543411,814,26,788,0,19,20
549421,548740,681,14,667,0,19,20
557290,556459,831,0,764,67,20,20
565770,565045,725,0,698,27,20,20
558116,557459,657,30,627,0,19,20
560283,559710,573,0,573,0,19,19
568300,567531,769,46,723,0,19,20
579897,579043,854,54,800,0,19,20
581101,580289,812,0,771,41,20,20
580273,579526,747,30,717,0,19,20
590038,589392,646,0,646,0,19,19
597984,597287,697,0,697,0,19,19
601839,601119,720,0,720,0,19,19
611268,610530,738,0,738,0,19,19
611204,610587,617,0,617,0,19,19
620338,619608,730,0,717,13,20,20
631383,630789,594,0,594,0,19,19
631795,631103,692,36,656,0,19,20
639138,638524,614,0,614,0,19,19
643352,642670,682,0,682,0,19,19
640942,639904,1038,54,984,0,19,20
633559,632541,1018,0,940,78,20,20
635196,634408,788,68,720,0,19,20
631719,631013,706,0,706,0,19,19
636572,635854,718,0,718,0,19,19
627435,626455,980,0,920,60,20,20
630769,629849,920,0,850,70,20,20
641609,640756,853,43,810,0,19,20
641943,641100,843,0,843,0,19,19
652108,651321,787,55,732,0,19,20
648426,647693,733,0,733,0,19,19
642073,641403,670,0,670,0,19,19
637589,636739,850,0,799,51,20,20
642816,642000,816,0,766,50,20,20
642152,641362,790,0,790,0,19,19
648908,648138,770,0,770,0,19,19
646537,645682,855,0,855,0,19,19
641426,640482,944,0,944,0,19,19
652461,651776,685,0,685,0,19,19
652104,651217,887,27,860,0,19,20
647148,646216,932,0,932,0,19,19
648370,647571,799,0,753,46,20,20
649304,648521,783,0,783,0,19,19
643783,642993,790,0,790,0,19,19
644976,644183,793,50,743,0,19,20
648505,647681,824,0,792,32,20,20
652152,651360,792,0,792,0,19,19
652108,651318,790,0,790,0,19,19
654402,653522,880,0,824,56,20,20
654173,653293,880,0,880,0,19,19
642182,641310,872,0,872,0,19,19
642725,641832,893,42,851,0,19,20
646981,646234,747,0,706,41,20,20
640837,640095,742,0,742,0,19,19
632116,631358,758,30,728,0,19,20
627428,626674,754,57,697,0,19,20
629885,629058,827,0,768,59,20,20
623742,622904,838,0,838,0,19,19
617373,616599,774,0,774,0,19,19
624260,623465,795,0,795,0,19,19
629342,628510,832,55,777,0,19,20
634013,633238,775,0,775,0,19,19
635396,634573,823,0,761,62,20,20
633915,633116,799,0,799,0,19,19
634562,633774,788,0,788,0,19,19
637609,636969,640,0,640,0,19,19
637632,636696,936,0,936,0,19,19
637288,636504,784,27,757,0,19,20
631588,630650,938,0,898,40,20,20
633597,632879,718,0,718,0,19,19
635233,634598,635,3,632,0,19,20
640859,640114,745,0,745,0,19,19
632086,631368,718,0,677,41,20,20
631122,630436,686,0,686,0,19,19
620657,619930,727,0,727,0,19,19
624659,623880,779,0,779,0,19,19
612807,611970,837,58,779,0,19,20
613733,612968,765,30,735,0,19,20
611046,610344,702,39,663,0,19,20
608279,607507,772,0,772,0,19,19
604347,603589,758,0,758,0,19,19
597087,596271,816,46,770,0,19,20
599656,598999,657,0,657,0,19,19
607444,606623,821,0,821,0,19,19
606449,605736,713,0,713,0,19,19
600354,599525,829,0,829,0,19,19
587984,587211,773,0,773,0,19,19
584792,584138,654,31,623,0,19,20
589961,589376,585,0,560,25,20,20
601559,600805,754,0,754,0,19,19
596142,595239,903,0,903,0,19,19
595599,594598,1001,0,1001,0,19,19
596889,595443,1446,79,1367,0,19,20
597988,597059,929,0,929,0,19,19
590917,590021,896,0,896,0,19,19
579676,578462,1214,62,1152,0,19,20
574775,573845,930,28,902,0,19,20
575818,574876,942,47,895,0,19,20
579452,578540,912,0,912,0,19,19
581517,580402,1115,0,1028,87,20,20
581398,580250,1148,0,1068,80,20,20
583349,582397,952,43,909,0,19,20
582920,581964,956,0,956,0,19,19
587316,586259,1057,28,1029,0,19,20
592883,591864,1019,43,976,0,19,20
598298,597228,1070,0,1032,38,20,20
596276,595283,993,0,950,43,20,20
601497,600465,1032,39,993,0,19,20
597550,596517,1033,59,974,0,19,20
604526,603629,897,0,897,0,19,19
603470,602446,1024,0,1024,0,19,19
613673,612626,1047,0,1047,0,19,19
608272,607233,1039,0,1039,0,19,19
610666,609554,1112,0,1112,0,19,19
613761,612826,935,0,935,0,19,19
618273,617190,1083,0,1083,0,19,19
619967,618913,1054,0,1054,0,19,19
624604,623389,1215,0,1215,0,19,19
623559,622395,1164,0,1136,28,20,20
625932,624501,1431,0,1365,66,20,20
625071,623979,1092,0,1092,0,19,19
623815,622857,958,0,958,0,19,19
629790,628786,1004,0,1004,0,19,19
626935,625872,1063,0,1021,42,20,20
629867,628921,946,0,901,45,20,20
624587,623589,998,0,998,0,19,19
625873,624808,1065,0,1065,0,19,19
615604,614564,1040,0,1040,0,19,19
612236,611150,1086,0,1086,0,19,19
614698,613469,1229,97,1132,0,19,20
612670,611603,1067,0,1067,0,19,19
613711,612689,1022,0,1022,0,19,19
608849,607740,1109,0,1109,0,19,19
600257,599422,835,0,835,0,19,19
606386,605420,966,0,966,0,19,19
604776,603851,925,0,925,0,19,19
603912,602664,1248,0,1170,78,20,20
602311,601327,984,0,984,0,19,19
584270,583445,825,0,825,0,19,19
590747,589750,997,62,935,0,19,20
585571,584551,1020,63,957,0,19,20
589873,589000,873,0,873,0,19,19
593525,592622,903,0,903,0,19,19
588474,587361,1113,0,1074,39,20,20
579347,578323,1024,0,1024,0,19,19
576354,575485,869,0,869,0,19,19
581563,580680,883,34,849,0,19,20
579395,578388,1007,51,956,0,19,20
571904,570965,939,0,939,0,19,19
571283,570313,970,0,970,0,19,19
572171,571321,850,0,850,0,19,19
580316,579411,905,0,905,0,19,19
571828,571037,791,0,791,0,19,19
563848,563111,737,0,737,0,19,19
567545,566613,932,0,932,0,19,19
560613,559848,765,0,765,0,19,19
567614,566817,797,0,797,0,19,19
565226,564296,930,66,864,0,19,20
562927,561852,1075,0,1025,50,20,20
560024,559064,960,0,929,31,20,20
562915,561986,929,0,893,36,20,20
562677,561768,909,0,909,0,19,19
563949,562875,1074,0,1074,0,19,19
575540,574299,1241,77,1164,0,19,20
569904,568913,991,0,991,0,19,19
571947,570862,1085,0,1085,0,19,19
568192,567167,1025,79,946,0,19,20
572865,571948,917,0,917,0,19,19
560714,559615,1099,0,1099,0,19,19
568958,568064,894,0,894,0,19,19
566501,565423,1078,30,1048,0,19,20
564767,563627,1140,0,1140,0,19,19
562878,561837,1041,65,976,0,19,20
560307,559340,967,0,967,0,19,19
560355,559295,1060,0,1060,0,19,19
562111,561149,962,0,962,0,19,19
560532,559533,999,0,999,0,19,19
558095,557114,981,65,916,0,19,20
560363,559297,1066,0,1066,0,19,19
557324,556255,1069,0,1069,0,19,19
560800,559999,801,0,801,0,19,19
563759,562815,944,0,944,0,19,19
562594,561634,960,0,960,0,19,19
568593,567440,1153,0,1111,42,20,20
578264,577163,1101,59,1042,0,19,20
578692,577726,966,0,966,0,19,19
577506,576415,1091,58,1033,0,19,20
569743,568451,1292,56,1236,0,19,20
568364,567405,959,0,959,0,19,19
572584,571536,1048,53,995,0,19,20
577609,576616,993,0,993,0,19,19
568540,567327,1213,49,1164,0,19,20
573275,572057,1218,62,1156,0,19,20
577435,576508,927,0,927,0,19,19
583221,582259,962,0,962,0,19,19
584419,583379,1040,0,1040,0,19,19
581997,581097,900,0,900,0,19,19
582322,581169,1153,0,1153,0,19,19
578015,576855,1160,0,1160,0,19,19
574957,573982,975,0,975,0,19,19
576264,575074,1190,0,1129,61,20,20
583533,582483,1050,0,1050,0,19,19
582505,581280,1225,0,1225,0,19,19
594055,593125,930,49,881,0,19,20
597136,595969,1167,0,1167,0,19,19
594977,593822,1155,0,1096,59,20,20
599491,598337,1154,79,1075,0,19,20
597759,596671,1088,0,1088,0,19,19
602953,601813,1140,0,1140,0,19,19
605961,605098,863,0,863,0,19,19
626707,625305,1402,0,1402,0,19,19
634510,633057,1453,0,1453,0,19,19
639737,638514,1223,0,1223,0,19,19
653164,651898,1266,0,1266,0,18,18
661352,660388,964,0,964,0,19,19
674167,672884,1283,0,1283,0,19,19
675597,674394,1203,65,1138,0,19,20
685002,684061,941,0,941,0,19,19
683431,682109,1322,0,1322,0,19,19
696550,695473,1077,0,1077,0,19,19
706949,706001,948,0,948,0,19,19
721051,719940,1111,0,1111,0,19,19
711209,709937,1272,0,1272,0,19,19
703688,702355,1333,0,1256,77,20,20
698651,697517,1134,0,1134,0,19,19
709376,708357,1019,0,1019,0,19,19
707134,706077,1057,0,1057,0,19,19
704272,703319,953,0,953,0,19,19
716034,714667,1367,0,1367,0,19,19
730162,728880,1282,0,1282,0,19,19
741122,739370,1752,0,1654,98,20,20
748274,746894,1380,0,1380,0,19,19
738488,737407,1081,0,1081,0,19,19
744661,743270,1391,0,1391,0,19,19
747385,746113,1272,0,1272,0,19,19
747776,746384,1392,86,1306,0,19,20
769742,768576,1166,0,1095,71,20,20
794308,793180,1128,0,1128,0,19,19
799260,797962,1298,0,1298,0,19,19
787877,786423,1454,0,1454,0,19,19
791893,790672,1221,0,1221,0,19,19
798332,796654,1678,0,1678,0,19,19
816866,815497,1369,0,1318,51,20,20
828081,826864,1217,0,1217,0,19,19
834363,832834,1529,0,1529,0,19,19
849872,848368,1504,0,1504,0,19,19
857080,855325,1755,120,1635,0,19,20
858754,856822,1932,100,1832,0,19,20
867279,865818,1461,0,1461,0,19,19
884047,882663,1384,0,1384,0,19,19
903640,902247,1393,0,1393,0,19,19
914652,912909,1743,83,1660,0,19,20
915888,914191,1697,0,1597,100,20,20
920397,919037,1360,61,1299,0,19,20
939091,937386,1705,93,1612,0,19,20
955217,953487,1730,0,1730,0,19,19
958490,956745,1745,0,1745,0,19,19
980782,979058,1724,80,1644,0,19,20
980300,978815,1485,0,1485,0,19,19
970446,968742,1704,0,1704,0,19,19
974951,973262,1689,0,1604,85,20,20
979585,977677,1908,0,1908,0,19,19
976869,975387,1482,0,1482,0,19,19
1003243,1001147,2096,136,1960,0,19,20
997333,995637,1696,0,1611,85,20,20
999301,997560,1741,0,1644,97,20,20
1010159,1008242,1917,0,1917,0,19,19
1374408,1373042,1366,0,1366,0,12,12
1382504,1379733,2771,129,2642,0,19,20
1399159,1397012,2147,0,2147,0,19,19
1431743,1428979,2764,117,2647,0,19,20
1405605,1402965,2640,0,2508,132,20,20
1451557,1448955,2602,0,2602,0,19,19
1447667,1445429,2238,0,2238,0,19,19
1441231,1438306,2925,0,2925,0,19,19
1443404,1440890,2514,80,2434,0,19,20
1457722,1454855,2867,0,2721,146,20,20
1430508,1428127,2381,0,2381,0,19,19
1436889,1434348,2541,171,2370,0,19,20
1445650,1443556,2094,0,2094,0,19,19
1436591,1434382,2209,0,2209,0,19,19
1439769,1437242,2527,0,2527,0,19,19
1449317,1446806,2511,0,2511,0,19,19
1427913,1425249,2664,0,2664,0,19,19
1431147,1428527,2620,0,2620,0,19,19
1460433,1457813,2620,0,2464,156,20,20
