"POSITION","REF_CODON","CODON","REF_AA","AA","FWD_CNT","FWD_DENOM","REV_CNT","REV_DENOM","CNT","DENOM","std.bias","id"
11,"GCA","TGG","A","W",0,185653,25,376180,25,561833,5.11054394515077,305
19,"TAC","TTC","Y","F",7,90293,0,415127,7,505420,4.15962170144589,532
30,"ACA","TTT","T","F",0,143041,23,386077,23,529118,4.38306096942421,847
36,"ATT","AGT","I","S",0,190435,16,343282,16,533717,4.49922153815187,998
47,"GCT","AGG","A","R",9,230673,0,229402,9,460075,4.60445817504216,1309
48,"GTG","GAG","V","E",0,232529,7,221113,7,453642,4.17292037667123,1346
53,"AAA","GAA","K","E",10,242680,0,206314,10,448994,4.48269585329474,1492
60,"CCT","AAC","P","N",11,261312,0,180555,11,441867,4.2452943986275,1668
85,"TTT","GTT","F","V",14,285951,0,227702,14,513653,4.96734601500974,2399
97,"AAG","TAG","K",".",9,274980,0,243850,9,518830,4.37761485313105,2738
132,"GCC","CCC","A","P",0,330450,7,275022,7,605472,4.16964625025006,3739
222,"GTT","GTA","V","V",0,297979,9,266399,9,564378,4.61312840369191,6350
239,"ATT","AGT","I","S",0,316475,32,267418,32,583893,6.99367055499474,6817
239,"ATT","TAC","I","Y",8,316475,0,267418,8,583893,4.07471920151191,6834
265,"TTC","GTC","F","V",1,340759,250,279643,251,620402,9.66465419320931,7579
285,"ATC","CTC","I","L",8,304765,0,338211,8,642976,4.40442727090212,8157
290,"AAT","CAT","N","H",781,258744,5,338080,786,596824,9.74022481075326,8297
291,"GGC","GAT","G","D",17,284484,1,339772,18,624256,4.4030673792205,8328
342,"TTT","TGT","F","C",10,281294,0,301913,10,583207,4.80293863820086,9791
344,"GGG","GAC","G","D",0,287807,8,312455,8,600262,4.2441063935162,9839
345,"AAC","ACC","N","T",53,274987,0,312592,53,587579,7.97823332495211,9859
410,"TAC","TCC","Y","S",63,301699,0,322280,63,623979,8.31797991778576,11735
411,"GGT","CGT","G","R",7,304847,0,325921,7,630768,4.1724571005106,11752
440,"TCT","TCA","S","S",0,288918,11,309804,11,598722,4.83831242848406,12598
466,"GTA","GAA","V","E",0,345164,9,294323,9,639487,4.61241360967582,13326
467,"AAA","GAA","K","E",0,343027,10,291234,10,634261,4.80172758574737,13359
473,"ATA","AGA","I","R",8,331342,0,297134,8,628476,4.19166860264304,13520
584,"TAC","TTC","Y","F",8,258687,0,282497,8,541184,4.40474248862904,16716
589,"TAC","CAC","Y","H",13,260464,0,275379,13,535843,5.28266956725399,16841
609,"ATT","ATA","I","I",0,257603,8,249663,8,507266,4.40598187956593,17413
647,"ATA","ATC","I","I",36,267979,1,283693,37,551672,5.83814455240167,18490
698,"CAT","ATG","H","M",0,220599,7,225937,7,446536,4.12726130382547,19935
759,"TTT","ATT","F","I",6,558264,54,435958,60,994222,4.13267270201696,21715
762,"CTA","CAA","L","Q",7,438425,0,579218,7,1017643,4.16779376794907,21808
