"POSITION","REF_CODON","CODON","REF_AA","AA","FWD_CNT","FWD_DENOM","REV_CNT","REV_DENOM","CNT","DENOM","std.bias","id"
175,"AAT","ACT","N","T",11,91761,0,98794,11,190555,4.97578434023787,1239
220,"GTG","GTT","V","V",0,90486,9,86065,9,176551,4.6141746530728,1546
222,"GTT","GTG","V","V",0,93493,20,84703,20,178196,6.090903345178,1560
239,"ATT","AGT","I","S",0,97990,14,85487,14,183477,5.41947611794818,1670
265,"TTC","GTC","F","V",0,105721,173,86241,173,191962,10.3181324894554,1852
266,"CCC","CTC","P","L",0,104913,8,92067,8,196980,4.40391100241514,1865
290,"AAT","CAT","N","H",328,77004,0,106190,328,183194,11.5921203185911,2053
345,"AAC","ACC","N","T",29,86645,1,98883,30,185528,5.41950472837403,2439
410,"TAC","TCC","Y","S",30,93042,0,100059,30,193101,6.86887291689052,2893
541,"GAT","AAT","D","N",0,82413,7,88518,7,170931,4.03400118311695,3818
572,"AAC","AAA","N","K",0,79219,8,85138,8,164357,4.26472493069034,4020
647,"ATA","ATC","I","I",18,83448,1,88035,19,171483,4.51248628457142,4511
